insert into e6(word,meaning) value('abbreviation',           	'n.节略,缩写,缩短');
insert into e6(word,meaning) value('abide',                  	'vt.遵守 vt.忍受');
insert into e6(word,meaning) value('abolish',                	'vt.废除,取消');
insert into e6(word,meaning) value('absent',                 	'a.不在意的');
insert into e6(word,meaning) value('absorption',             	'n.吸收;专注');
insert into e6(word,meaning) value('abstract',               	'a.理论上的 n.抽象');
insert into e6(word,meaning) value('absurd',                 	'a.不合理的,荒唐的');
insert into e6(word,meaning) value('abundance',              	'n.丰富,充裕');
insert into e6(word,meaning) value('accessory',              	'n.同谋 a.附属的');
insert into e6(word,meaning) value('accord',                 	'n.调和,符合;协议');
insert into e6(word,meaning) value('acknowledge',            	'vt.承认;告知收到');
insert into e6(word,meaning) value('acquaint',               	'vt.使认识,使了解');
insert into e6(word,meaning) value('action',                 	'n.作用;情节');
insert into e6(word,meaning) value('adhere',                 	'vi.粘附;追随;坚持');
insert into e6(word,meaning) value('adjacent',               	'a.毗连的;紧接着的');
insert into e6(word,meaning) value('adjoin',                 	'vt.贴近,毗连;靠近');
insert into e6(word,meaning) value('adjustable',             	'a.可调整的,可校准的');
insert into e6(word,meaning) value('administration',         	'n.局(或署、处等)');
insert into e6(word,meaning) value('admiration',             	'n.钦佩;赞美,羡慕');
insert into e6(word,meaning) value('adoption',               	'n.收养;采纳,采取');
insert into e6(word,meaning) value('adore',                  	'vt.崇拜;很喜欢');
insert into e6(word,meaning) value('advantageous',           	'a.有利的,有助的');
insert into e6(word,meaning) value('advertise',              	'vt.通知 vi.登广告');
insert into e6(word,meaning) value('advocate',               	'n.辩护者 vt.拥护');
insert into e6(word,meaning) value('aerial',                 	'a.空气的;航空的');
insert into e6(word,meaning) value('aerospace',              	'n.航空和宇宙航行空间');
insert into e6(word,meaning) value('affirm',                 	'vt.断言,批准;证实');
insert into e6(word,meaning) value('agitation',              	'n.鼓动,煸动;搅动');
insert into e6(word,meaning) value('agreeable',              	'a.惬意的;同意的');
insert into e6(word,meaning) value('alas',                   	'int.唉,哎呀');
insert into e6(word,meaning) value('album',                  	'n.粘贴簿;相册;文选');
insert into e6(word,meaning) value('alert',                  	'a.警惕的;活跃的');
insert into e6(word,meaning) value('algebra',                	'n.代数学');
insert into e6(word,meaning) value('alien',                  	'a.外国的 n.外国人');
insert into e6(word,meaning) value('alignment',              	'n.队列;结盟,联合');
insert into e6(word,meaning) value('allied',                 	'a.联合的;联姻的');
insert into e6(word,meaning) value('allowance',              	'n津贴,补助费');
insert into e6(word,meaning) value('alongside',              	'prep.在…旁边');
insert into e6(word,meaning) value('ally',                   	'n.盟国,同盟者,伙伴');
insert into e6(word,meaning) value('alteration',             	'n.变更,改变;蚀变');
insert into e6(word,meaning) value('alternate',              	'vt.使交替 a.交替的');
insert into e6(word,meaning) value('amateur',                	'a.业余的n.业余爱好者');
insert into e6(word,meaning) value('ambassador',             	'n.大使,使节');
insert into e6(word,meaning) value('ambient',                	'a.周围的,包围着的');
insert into e6(word,meaning) value('ambiguous',              	'a.模棱两可的;分歧的');
insert into e6(word,meaning) value('ambitious',              	'a.有雄心的;热望的');
insert into e6(word,meaning) value('ample',                  	'a.足够的;宽敞的');
insert into e6(word,meaning) value('amplitude',              	'n.广大;充足;振幅');
insert into e6(word,meaning) value('amusement',              	'n.娱乐,消遣,乐趣');
insert into e6(word,meaning) value('analogue',               	'n.类似物;同源语');
insert into e6(word,meaning) value('analogy',                	'n.相似,类似;比拟');
insert into e6(word,meaning) value('analytic(al)','a.分析的;分解的');
insert into e6(word,meaning) value('anniversary',            	'n.周年纪念日');
insert into e6(word,meaning) value('announce',               	'vt.报告…的来到');
insert into e6(word,meaning) value('annually',               	'ad.年年,每年');
insert into e6(word,meaning) value('anode',                  	'n.阳极,正极,板极');
insert into e6(word,meaning) value('answer',                 	'vi.符合,适合');
insert into e6(word,meaning) value('antarctic',              	'a.南极的 n.南极区');
insert into e6(word,meaning) value('antenna',                	'n.触角;天线');
insert into e6(word,meaning) value('antique',                	'a.古代的 n.古物');
insert into e6(word,meaning) value('anybody',                	'n.重要人物');
insert into e6(word,meaning) value('apparent',               	'a.显然的');
insert into e6(word,meaning) value('appendix',               	'n.附录,附属物;阑尾');
insert into e6(word,meaning) value('applaud',                	'vt.喝彩;欢呼vi.欢呼');
insert into e6(word,meaning) value('applause',               	'n.喝彩;夸奖,称赞');
insert into e6(word,meaning) value('appreciable',            	'a.可估价的;可察觉的');
insert into e6(word,meaning) value('appreciation',           	'n.欣赏;鉴别;感激');
insert into e6(word,meaning) value('apt',                    	'a.恰当的;聪明的');
insert into e6(word,meaning) value('arc',                    	'n.弧,弓形物;弧光');
insert into e6(word,meaning) value('arch',                   	'n.拱门 vt.用拱连接');
insert into e6(word,meaning) value('architect',              	'n.建筑师;创造者');
insert into e6(word,meaning) value('arctic',                 	'a.北极的 n.北极');
insert into e6(word,meaning) value('array',                  	'vt.装扮 n.队列;排列');
insert into e6(word,meaning) value('ascend',                 	'vi.攀登,登高;追溯');
insert into e6(word,meaning) value('ascertain',              	'vt.查明,确定,弄清');
insert into e6(word,meaning) value('ascribe',                	'vt.把…归于');
insert into e6(word,meaning) value('ashore',                 	'ad.在岸上,上岸');
insert into e6(word,meaning) value('ass',                    	'n.驴;傻瓜,蠢笨的人');
insert into e6(word,meaning) value('assassinate',            	'vt.暗杀,行刺;中伤');
insert into e6(word,meaning) value('assault',                	'vt.袭击;殴打 n.攻击');
insert into e6(word,meaning) value('assert',                 	'vt.断言,宣称;维护');
insert into e6(word,meaning) value('assessment',             	'n.估定;查定;估计数');
insert into e6(word,meaning) value('assumption',             	'n.采取;假定;傲慢');
insert into e6(word,meaning) value('assurance',              	'n.保证;财产转让书');
insert into e6(word,meaning) value('astonishment',           	'n.惊奇,惊讶');
insert into e6(word,meaning) value('astronomy',              	'n.天文学');
insert into e6(word,meaning) value('atom',                   	'n.微粒;微量');
insert into e6(word,meaning) value('attachment',             	'n.连接物,附件;爱慕');
insert into e6(word,meaning) value('attendance',             	'n.到场;出席人数');
insert into e6(word,meaning) value('attendant',              	'n.侍者;护理人员');
insert into e6(word,meaning) value('attorney',               	'n.代理人;辩护律师');
insert into e6(word,meaning) value('audience',               	'n.正式会见;拜会');
insert into e6(word,meaning) value('author',                 	'n.创造者,创始人');
insert into e6(word,meaning) value('automate',               	'vt.使自动化');
insert into e6(word,meaning) value('avail',                  	'vt.有益于 n.效用');
insert into e6(word,meaning) value('availability',           	'n.有效(性);可得性');
insert into e6(word,meaning) value('aviation',               	'n.飞行');
insert into e6(word,meaning) value('awake',                  	'vi.认识到');
insert into e6(word,meaning) value('awful',                  	'a.威严的;令人崇敬的');
insert into e6(word,meaning) value('awkward',                	'a.不雅观的');
insert into e6(word,meaning) value('axial',                  	'a.轴的;轴向的');
insert into e6(word,meaning) value('axis',                   	'n.轴,轴线;第二颈椎');
insert into e6(word,meaning) value('axle',                   	'n.(轮)轴,车轴,心棒');
insert into e6(word,meaning) value('baby',                   	'n.一家中年龄最小的人');
insert into e6(word,meaning) value('bachelor',               	'n.未婚男子;学士');
insert into e6(word,meaning) value('bacon',                  	'n.咸猪肉,熏猪肉');
insert into e6(word,meaning) value('bacterium',              	'n.细菌;拳击迷');
insert into e6(word,meaning) value('badge',                  	'n.徽章,像章;标志');
insert into e6(word,meaning) value('baffle',                 	'vt.使挫折 n.迷惑');
insert into e6(word,meaning) value('bait',                   	'n.饵;引诱物');
insert into e6(word,meaning) value('balcony',                	'n.阳台;楼厅,楼座');
insert into e6(word,meaning) value('bald',                   	'a.秃头的;无毛的');
insert into e6(word,meaning) value('ballet',                 	'n.芭蕾舞;舞剧');
insert into e6(word,meaning) value('bamboo',                 	'n.竹;竹杆,竹棍');
insert into e6(word,meaning) value('bandage',                	'n.绷带,包带');
insert into e6(word,meaning) value('bandit',                 	'n.土匪,盗匪,歹徒');
insert into e6(word,meaning) value('bank',                   	'vi.把钱存入银行');
insert into e6(word,meaning) value('banker',                 	'n.银行家');
insert into e6(word,meaning) value('bankrupt',               	'a.破产的 vt.使破产');
insert into e6(word,meaning) value('banquet',                	'n.宴会,盛会,酒席');
insert into e6(word,meaning) value('barely',                 	'ad.仅仅,勉强');
insert into e6(word,meaning) value('barge',                  	'n.驳船;大型游船');
insert into e6(word,meaning) value('barley',                 	'n.大麦');
insert into e6(word,meaning) value('barometer',              	'n.气压计,睛雨表');
insert into e6(word,meaning) value('baron',                  	'n.男爵;贵族;巨商');
insert into e6(word,meaning) value('barren',                 	'a.贫瘠的;不妊的');
insert into e6(word,meaning) value('baseball',               	'n.棒球;棒球运动');
insert into e6(word,meaning) value('basement',               	'n.地下室;地窖;底层');
insert into e6(word,meaning) value('basin',                  	'n.内海;盆地,流域');
insert into e6(word,meaning) value('battery',                	'n.炮兵连;兵器群');
insert into e6(word,meaning) value('battle',                 	'vi.战斗 vt.与…作战');
insert into e6(word,meaning) value('bazaar',                 	'n.集市,廉价商店');
insert into e6(word,meaning) value('bead',                   	'n.有孔小珠;露珠');
insert into e6(word,meaning) value('beam',                   	'vi.发光,发热;微笑');
insert into e6(word,meaning) value('bearing',                	'n.支承;忍受;方位');
insert into e6(word,meaning) value('bed',                    	'n.河床,(湖)底,矿床');
insert into e6(word,meaning) value('beetle',                 	'n.甲虫;近视眼的人');
insert into e6(word,meaning) value('beforehand',             	'ad.预先;提前地');
insert into e6(word,meaning) value('bend',                   	'vt.使屈从 vi.屈从');
insert into e6(word,meaning) value('bestow',                 	'vt.把…赠与');
insert into e6(word,meaning) value('between',                	'ad.当中,中间');
insert into e6(word,meaning) value('beware',                 	'vt.&vi.谨防,当心');
insert into e6(word,meaning) value('bewilder',               	'vt.迷惑,把…弄糊涂');
insert into e6(word,meaning) value('bid',                    	'vt.命令 vi.报价');
insert into e6(word,meaning) value('bishop',                 	'n.(基督教的)主教');
insert into e6(word,meaning) value('bitterness',             	'n.苦味,辛酸,苦难');
insert into e6(word,meaning) value('blacksmith',             	'n.铁匠,锻工');
insert into e6(word,meaning) value('blast',                  	'n.管乐器的声音');
insert into e6(word,meaning) value('blaze',                  	'vt.使燃烧 vi.燃烧');
insert into e6(word,meaning) value('bleach',                 	'vt.漂白 vi.变白');
insert into e6(word,meaning) value('blind',                  	'n.百叶窗;窗帘;遮帘');
insert into e6(word,meaning) value('block',                  	'n.阻塞;障碍物;炮闩');
insert into e6(word,meaning) value('blond',                  	'n.白肤金发碧眼的人');
insert into e6(word,meaning) value('blouse',                 	'n.女衬衫;童衫;罩衫');
insert into e6(word,meaning) value('blue',                   	'a.伤心的;下流的');
insert into e6(word,meaning) value('blunder',                	'vi.犯大错 n.大错');
insert into e6(word,meaning) value('blush',                  	'vi.脸红,害臊 n.脸红');
insert into e6(word,meaning) value('board',                  	'vt.(收费)供…膳食');
insert into e6(word,meaning) value('body',                   	'n.物体;(液)体;实质');
insert into e6(word,meaning) value('boiler',                 	'n.锅炉;热水贮槽');
insert into e6(word,meaning) value('bore',                   	'n.讨厌的人;麻烦事');
insert into e6(word,meaning) value('bound',                  	'a.应当的;必定的');
insert into e6(word,meaning) value('bourgeois',              	'a.资产阶级的;平庸的');
insert into e6(word,meaning) value('box',                    	'n.专席');
insert into e6(word,meaning) value('boycott',                	'vt.&n.联合抵制');
insert into e6(word,meaning) value('brace',                  	'n.支柱 vt.拉紧,撑牢');
insert into e6(word,meaning) value('brand',                  	'vt.在…上打烙印');
insert into e6(word,meaning) value('breakdown',              	'n.崩溃,倒塌;失败');
insert into e6(word,meaning) value('breakfast',              	'vi.吃早餐');
insert into e6(word,meaning) value('breed',                  	'n.(动物)品种');
insert into e6(word,meaning) value('bribe',                  	'n.贿赂 vt.向…行贿');
insert into e6(word,meaning) value('bridegroom',             	'n.新郎');
insert into e6(word,meaning) value('bridge',                 	'vt.架桥于,用桥连接');
insert into e6(word,meaning) value('bridle',                 	'n.笼子;束缚 vt.抑制');
insert into e6(word,meaning) value('brightness',             	'n.明亮,辉煌,聪明');
insert into e6(word,meaning) value('broaden',                	'vt.&vi.放宽,变阔');
insert into e6(word,meaning) value('bronze',                 	'n.青铜色');
insert into e6(word,meaning) value('brood',                  	'vt.沉思vi.郁闭地沉思');
insert into e6(word,meaning) value('Buddhism',               	'n.佛教,释教');
insert into e6(word,meaning) value('budget',                 	'n.预算,预算案');
insert into e6(word,meaning) value('buffalo',                	'n.水牛;水陆坦克');
insert into e6(word,meaning) value('bug',                    	'n.虫子;臭虫');
insert into e6(word,meaning) value('bugle',                  	'n.军号,喇叭');
insert into e6(word,meaning) value('bull',                   	'n.买空的证券投机商');
insert into e6(word,meaning) value('bulletin',               	'告示,公告,公报');
insert into e6(word,meaning) value('bump',                   	'vt.撞击 vi.撞 n.肿块');
insert into e6(word,meaning) value('bureaucracy',            	'n.官僚主义;官僚机构');
insert into e6(word,meaning) value('burglar',                	'n.夜盗,窃贼');
insert into e6(word,meaning) value('burial',                 	'n.安葬,埋葬,埋藏');
insert into e6(word,meaning) value('burner',                 	'n.灯头,煤气头');
insert into e6(word,meaning) value('bushel',                 	'n.蒲式耳(容量单位)');
insert into e6(word,meaning) value('butt',                   	'n.大酒桶,桶');
insert into e6(word,meaning) value('buzz',                   	'vi.(蜂等)嗡嗡叫');
insert into e6(word,meaning) value('bypass',                 	'n.旁通管 vt.绕过');
insert into e6(word,meaning) value('by-product',             	'n.副产品');
insert into e6(word,meaning) value('cable',                  	'n.海底电报');
insert into e6(word,meaning) value('calculus',               	'n.微积分;结石');
insert into e6(word,meaning) value('calibration',            	'n.校准;标定,刻度');
insert into e6(word,meaning) value('can',                    	'vt.装罐头');
insert into e6(word,meaning) value('cane',                   	'n.(藤等)茎;手杖');
insert into e6(word,meaning) value('cancel',                 	'vt.删去,勾销,取消');
insert into e6(word,meaning) value('capability',             	'n.能力,才能;性能');
insert into e6(word,meaning) value('capacitance',            	'n.电容,电容量');
insert into e6(word,meaning) value('capacitor',              	'n.电容器');
insert into e6(word,meaning) value('cape',                   	'n.披肩,斗篷;海角');
insert into e6(word,meaning) value('captive',                	'a.被俘虏的;被迷住的');
insert into e6(word,meaning) value('carry',                  	'vt.刊登');
insert into e6(word,meaning) value('cartoon',                	'n.漫画,动画片');
insert into e6(word,meaning) value('cartridge',              	'n.弹药筒,子弹;软片');
insert into e6(word,meaning) value('catalogue',              	'vt.为…编目录');
insert into e6(word,meaning) value('catalyst',               	'n.催化剂;刺激因素');
insert into e6(word,meaning) value('category',               	'n.种类,类目;范畴');
insert into e6(word,meaning) value('cater',                  	'vi.迎合,投合');
insert into e6(word,meaning) value('Catholic',               	'a.天主教的n.天主教徒');
insert into e6(word,meaning) value('caution',                	'n.小心;告诫 vt.警告');
insert into e6(word,meaning) value('cautious',               	'a.小心的,谨慎的');
insert into e6(word,meaning) value('cavity',                 	'n.洞,穴,空腔');
insert into e6(word,meaning) value('cement',                 	'vt.粘结 vi.粘紧');
insert into e6(word,meaning) value('censor',                 	'vt.审查,检查');
insert into e6(word,meaning) value('cereal',                 	'n.谷类,五谷,禾谷');
insert into e6(word,meaning) value('certainty',              	'n.确实性,确信,确实');
insert into e6(word,meaning) value('challenge',              	'n.艰巨任务;要求回避');
insert into e6(word,meaning) value('champion',               	'n.斗士;提倡者');
insert into e6(word,meaning) value('characterize',           	'vt.表示…的特性');
insert into e6(word,meaning) value('charcoal',               	'n.炭,木炭;生物炭');
insert into e6(word,meaning) value('charge',                 	'n.负荷;充电 vt.装满');
insert into e6(word,meaning) value('charm',                  	'n.魅力;妩媚 vi.迷人');
insert into e6(word,meaning) value('charter',                	'vt.租 n.宪章;契据');
insert into e6(word,meaning) value('chatter',                	'vi.&n.喋喋不休');
insert into e6(word,meaning) value('cheat',                  	'n.欺诈;骗取');
insert into e6(word,meaning) value('check',                  	'n.支票,帐单');
insert into e6(word,meaning) value('cherish',                	'vt.珍爱;怀有(感情)');
insert into e6(word,meaning) value('chestnut',               	'n.栗子;栗树;栗色');
insert into e6(word,meaning) value('chill',                  	'vi.感到寒冷;冷淬');
insert into e6(word,meaning) value('chip',                   	'n.薄片,碎片');
insert into e6(word,meaning) value('choice',                 	'n.入选者 a.优等的');
insert into e6(word,meaning) value('chop',                   	'n.一块排骨,肉块');
insert into e6(word,meaning) value('chord',                  	'n.(乐器的)弦 vi.协调');
insert into e6(word,meaning) value('chorus',                 	'vt.&vi.合唱');
insert into e6(word,meaning) value('Christ',                 	'n.救世主(耶稣基督)');
insert into e6(word,meaning) value('Christian',              	'a.基督教的');
insert into e6(word,meaning) value('cigar',                  	'n.雪茄烟,叶卷烟');
insert into e6(word,meaning) value('circular',               	'n.传单,通报,通函');
insert into e6(word,meaning) value('circulation',            	'n.循环;(货币等)流通');
insert into e6(word,meaning) value('circus',                 	'n.马戏;马戏团');
insert into e6(word,meaning) value('cite',                   	'vt.引用,引证;举例');
insert into e6(word,meaning) value('civilian',               	'n.平民 a.平民的');
insert into e6(word,meaning) value('claim',                  	'n.权利,所有权');
insert into e6(word,meaning) value('clamp',                  	'n.夹子 vt.夹住,夹紧');
insert into e6(word,meaning) value('clap',                   	'n.拍手喝采声;霹雳声');
insert into e6(word,meaning) value('clash',                  	'n.碰撞声;抵触,冲突');
insert into e6(word,meaning) value('clasp',                  	'vt.扣住,扣紧,钩住');
insert into e6(word,meaning) value('classic',                	'n.名著 a.不朽的');
insert into e6(word,meaning) value('clatter',                	'n.得得声,卡嗒声');
insert into e6(word,meaning) value('cleanliness',            	'n.清洁');
insert into e6(word,meaning) value('clearing',               	'n.(森林中的)空旷地');
insert into e6(word,meaning) value('client',                 	'n.顾客;诉讼委托人');
insert into e6(word,meaning) value('climax',                 	'n.(兴趣的)顶点');
insert into e6(word,meaning) value('cling',                  	'vi.粘住;依附;坚持');
insert into e6(word,meaning) value('clinic',                 	'n.诊所,医务室;会诊');
insert into e6(word,meaning) value('clip',                   	'vt.夹住 n.夹子,钳子');
insert into e6(word,meaning) value('clip',                   	'vt.剪;剪辑报刊');
insert into e6(word,meaning) value('cloak',                  	'vt.掩盖,覆盖,掩饰');
insert into e6(word,meaning) value('clockwise',              	'a.&ad.顺时针方向转的');
insert into e6(word,meaning) value('closet',                 	'n.小房间;壁碗橱');
insert into e6(word,meaning) value('cloudy',                 	'a.混浊的;模糊不清的');
insert into e6(word,meaning) value('clown',                  	'n.(马戏的)小丑,丑角');
insert into e6(word,meaning) value('cluster',                	'n.一串 vt.使成群');
insert into e6(word,meaning) value('clutch',                 	'vt.抓住 vi.掌握,攫');
insert into e6(word,meaning) value('coach',                  	'vt.辅导,指导,训练');
insert into e6(word,meaning) value('cock',                   	'n.旋塞,开关,龙头');
insert into e6(word,meaning) value('coefficient',            	'n.协同因素;系数,率');
insert into e6(word,meaning) value('coffin',                 	'n.棺材,柩');
insert into e6(word,meaning) value('coherent',               	'a.粘着的;紧凑的');
insert into e6(word,meaning) value('coin',                   	'vt.铸造(硬币)');
insert into e6(word,meaning) value('coincide',               	'vi.相符合;相巧合');
insert into e6(word,meaning) value('coke',                   	'n.焦炭 vt.&vi.炼焦');
insert into e6(word,meaning) value('collaborate',            	'vi.协作,合作;协调');
insert into e6(word,meaning) value('collide',                	'vi.碰撞;冲突,抵触');
insert into e6(word,meaning) value('colonial',               	'a.殖民地的,殖民的');
insert into e6(word,meaning) value('colonist',               	'n.移民;殖民地居民');
insert into e6(word,meaning) value('combat',                 	'vt.跟…战斗 vi.格斗');
insert into e6(word,meaning) value('combustion',             	'n.燃烧;氧化;骚动');
insert into e6(word,meaning) value('comedy',                 	'n.喜剧;喜剧场面');
insert into e6(word,meaning) value('commence',               	'vt.开始 vi.获得学位');
insert into e6(word,meaning) value('commend',                	'vt.称赞,表扬;推荐');
insert into e6(word,meaning) value('commission',             	'n.委托,委任;委托状');
insert into e6(word,meaning) value('commodity',              	'n.日用品,商品,物品');
insert into e6(word,meaning) value('commonplace',            	'a.平凡的 n.平常话');
insert into e6(word,meaning) value('commonsense',            	'a.有常识的');
insert into e6(word,meaning) value('commonwealth',           	'n.共和国;联邦');
insert into e6(word,meaning) value('compact',                	'a.紧密的 vt.使紧凑');
insert into e6(word,meaning) value('comparable',             	'a.可比较的;类似的');
insert into e6(word,meaning) value('compatible',             	'a.一致的;兼容制的');
insert into e6(word,meaning) value('compensate',             	'vt.&vi.补偿,赔偿');
insert into e6(word,meaning) value('compensation',           	'n.补偿,赔偿,赔偿费');
insert into e6(word,meaning) value('competitive',            	'a.竞争的,比赛的');
insert into e6(word,meaning) value('competitor',             	'n.竞争者,敌手');
insert into e6(word,meaning) value('complaint',              	'n.疾病,病痛;主诉');
insert into e6(word,meaning) value('complement',             	'vt.补充 n.补足(物)');
insert into e6(word,meaning) value('completion',             	'n.完成,结束,完满');
insert into e6(word,meaning) value('complexity',             	'n.复杂(性)');
insert into e6(word,meaning) value('complication',           	'n.复杂,混乱;并发症');
insert into e6(word,meaning) value('compliment',             	'n.问候 vt.赞美,祝贺');
insert into e6(word,meaning) value('comply',                 	'vi.应允,遵照,照做');
insert into e6(word,meaning) value('composer',               	'n.作曲家;调停人');
insert into e6(word,meaning) value('composite',              	'a.合成的 n.合成物');
insert into e6(word,meaning) value('composition',            	'n.组成,构成,结构');
insert into e6(word,meaning) value('comprehend',             	'vt.了解,理解,领会');
insert into e6(word,meaning) value('compression',            	'n.压缩,压紧,浓缩');
insert into e6(word,meaning) value('compulsory',             	'a.强迫的,义务的');
insert into e6(word,meaning) value('conceit',                	'n.自负,自高自大');
insert into e6(word,meaning) value('conceive',               	'vt.设想,以为;怀孕');
insert into e6(word,meaning) value('concentrate',            	'vt.&vi.浓缩,提浓');
insert into e6(word,meaning) value('conception',             	'n.概念,观念,想法');
insert into e6(word,meaning) value('concern',                	'n.所关切的事;商行');
insert into e6(word,meaning) value('concert',                	'n.一齐,一致,协作');
insert into e6(word,meaning) value('concession',             	'n.让步,迁就');
insert into e6(word,meaning) value('confidence',             	'n.私房话,秘密,机密');
insert into e6(word,meaning) value('confidential',           	'a.秘密的;亲信的');
insert into e6(word,meaning) value('confirmation',           	'n.证实,确定;确认');
insert into e6(word,meaning) value('conform',                	'vt.使遵守 vi.一致');
insert into e6(word,meaning) value('confront',               	'vt.使面对;使对证');
insert into e6(word,meaning) value('conqueror',              	'n.征服者,胜利者');
insert into e6(word,meaning) value('consciousness',          	'n.意识,知觉,觉悟');
insert into e6(word,meaning) value('consequence',            	'n.重要(性),重大意义');
insert into e6(word,meaning) value('consequent',             	'a.作为结果的;必然的');
insert into e6(word,meaning) value('conservative',           	'a.有保存力的,防腐的');
insert into e6(word,meaning) value('consistent',             	'a.前后一致的,连贯的');
insert into e6(word,meaning) value('console',                	'n.悬臂,肘托;控制台');
insert into e6(word,meaning) value('consolidate',            	'vt.巩固 vi.合并');
insert into e6(word,meaning) value('constituent',            	'a.形成的 n.选民');
insert into e6(word,meaning) value('constitute',             	'vt.构成,组成');
insert into e6(word,meaning) value('constitution',           	'n.(人的)体格,素质');
insert into e6(word,meaning) value('constraint',             	'n.强迫,结束;强制力');
insert into e6(word,meaning) value('construction',           	'n.结构;作图(法)');
insert into e6(word,meaning) value('consul',                 	'n.领事');
insert into e6(word,meaning) value('consumer',               	'n.消费者,用户');
insert into e6(word,meaning) value('consumption',            	'n.消费(量),灭绝');
insert into e6(word,meaning) value('contend',                	'vi.竞争 vt.坚决主张');
insert into e6(word,meaning) value('context',                	'n.上下文;来龙去脉');
insert into e6(word,meaning) value('continental',            	'a.大陆的,大陆性的');
insert into e6(word,meaning) value('contradict',             	'vt.反驳,否认');
insert into e6(word,meaning) value('contrary',               	'n.反对命题');
insert into e6(word,meaning) value('contrast',               	'vt.使对比vi.形成对比');
insert into e6(word,meaning) value('controversy',            	'n.争论,辩论,争吵');
insert into e6(word,meaning) value('convention',             	'n.公约,(换俘等)协定');
insert into e6(word,meaning) value('convert',                	'vt.转变,改变,变换');
insert into e6(word,meaning) value('convey',                 	'vt.传达;传播;转让');
insert into e6(word,meaning) value('conviction',             	'n.确信,信服,深信');
insert into e6(word,meaning) value('cooperative',            	'a.合作的 n.合作社');
insert into e6(word,meaning) value('coordinate',             	'a.同等的 n.同等的人');
insert into e6(word,meaning) value('correctly',              	'ad.正确地,恰当地');
insert into e6(word,meaning) value('correlate',              	'n.互相关联的事物');
insert into e6(word,meaning) value('correlation',            	'n.相互关系;对射');
insert into e6(word,meaning) value('correspondence',         	'n.通信;符合;对应');
insert into e6(word,meaning) value('corrosion',              	'n.腐蚀,侵蚀;锈');
insert into e6(word,meaning) value('corrupt',                	'vt.贿赂 a.腐败的');
insert into e6(word,meaning) value('cosmic',                 	'a.宇宙的;广大无边的');
insert into e6(word,meaning) value('cosmos',                 	'n.宇宙;秩序,和谐');
insert into e6(word,meaning) value('couch',                  	'n.睡椅,长沙发椅');
insert into e6(word,meaning) value('counsel',                	'n.商议;忠告;律师');
insert into e6(word,meaning) value('count',                  	'n.起拆理由,罪状');
insert into e6(word,meaning) value('counter',                	'a.&ad.相反的(地)');
insert into e6(word,meaning) value('courageous',             	'a.勇敢的,无畏的');
insert into e6(word,meaning) value('courteous',              	'a.有礼貌的,谦恭的');
insert into e6(word,meaning) value('courtesy',               	'n.礼貌,谦恭,请安');
insert into e6(word,meaning) value('coward',                 	'a.懦怯的,胆小的');
insert into e6(word,meaning) value('crab',                   	'n.蟹,蟹肉 vi.捕蟹');
insert into e6(word,meaning) value('crack',                  	'vi.&vt.发出爆裂声');
insert into e6(word,meaning) value('cradle',                 	'n.摇篮,发源地');
insert into e6(word,meaning) value('craft',                  	'n.技巧');
insert into e6(word,meaning) value('crank',                  	'n.曲柄 vi.转动曲柄');
insert into e6(word,meaning) value('crash',                  	'vi.撞坏,摔坏,砸碎');
insert into e6(word,meaning) value('credit',                 	'vt.&n.相信,信任');
insert into e6(word,meaning) value('crisis',                 	'n.危机;转折点');
insert into e6(word,meaning) value('crisp',                  	'a.脆的;卷曲的');
insert into e6(word,meaning) value('criterion',              	'n.标准,准则,尺度');
insert into e6(word,meaning) value('crooked',                	'a.弯的,歪的;畸形的');
insert into e6(word,meaning) value('cross',                  	'a.易怒的;杂交的');
insert into e6(word,meaning) value('cruelty',                	'n.残酷;残酷行为');
insert into e6(word,meaning) value('cruise',                 	'vi.巡航 vt.巡航于…');
insert into e6(word,meaning) value('cubic',                  	'a.立方体的;立方的');
insert into e6(word,meaning) value('cuckoo',                 	'n.杜鹃,布谷鸟');
insert into e6(word,meaning) value('curly',                  	'a.卷曲的;有卷毛的');
insert into e6(word,meaning) value('currency',               	'n.通货;通用;市价');
insert into e6(word,meaning) value('currently',              	'ad.普遍地;当前');
insert into e6(word,meaning) value('custom',                 	'n.海关,关税');
insert into e6(word,meaning) value('customary',              	'a.通常的;照惯例的');
insert into e6(word,meaning) value('cutter',                 	'n.用于切割的器械');
insert into e6(word,meaning) value('cylinder',               	'n.圆筒;柱(面);汽缸');
insert into e6(word,meaning) value('damn',                   	'vt.诅咒 n.诅咒;丝毫');
insert into e6(word,meaning) value('datum',                  	'n.资料;数据;已知数');
insert into e6(word,meaning) value('dazzle',                 	'vt.&vi.炫耀;迷惑');
insert into e6(word,meaning) value('deafen',                 	'vt.使聋;使隔音');
insert into e6(word,meaning) value('deal',                   	'vi.做买卖;对付');
insert into e6(word,meaning) value('dealer',                 	'n.商人,贩子;发牌者');
insert into e6(word,meaning) value('dean',                   	'n.(大学)院长,系主任');
insert into e6(word,meaning) value('decay',                  	'vt.使腐朽,使腐烂');
insert into e6(word,meaning) value('decidedly',              	'ad.明确地,坚决地');
insert into e6(word,meaning) value('decimal',                	'a.小数的,十进制的');
insert into e6(word,meaning) value('decisive',               	'a.决定性的;果断的');
insert into e6(word,meaning) value('declaration',            	'n.宣布,宣言;申诉');
insert into e6(word,meaning) value('decline',                	'vt.下倾;偏斜;衰退');
insert into e6(word,meaning) value('decompose',              	'vt.&vi.腐败;分解');
insert into e6(word,meaning) value('decorative',             	'a.装饰的;可作装饰的');
insert into e6(word,meaning) value('decree',                 	'n.法令,政令;教令');
insert into e6(word,meaning) value('dedicate',               	'vt.奉献;献身');
insert into e6(word,meaning) value('deem',                   	'vt.认为,相信 vi.想');
insert into e6(word,meaning) value('deepen',                 	'vt.加浓');
insert into e6(word,meaning) value('default',                	'n.&vi.不履行;缺席');
insert into e6(word,meaning) value('deficiency',             	'n.缺乏;不足之数');
insert into e6(word,meaning) value('deficient',              	'a.缺乏的;欠缺的');
insert into e6(word,meaning) value('define',                 	'vt.规定;立(界限)');
insert into e6(word,meaning) value('deflect',                	'vt.&vi.(使)偏斜');
insert into e6(word,meaning) value('deflection',             	'n.偏斜,歪斜;偏差');
insert into e6(word,meaning) value('deform',                 	'vt.损坏…的形状');
insert into e6(word,meaning) value('deformation',            	'n.损坏;变形;畸形');
insert into e6(word,meaning) value('defy',                   	'vt.向…挑战;蔑视');
insert into e6(word,meaning) value('degradation',            	'n.降级;退化;衰变');
insert into e6(word,meaning) value('degrade',                	'vt.使降给;使堕落');
insert into e6(word,meaning) value('delegate',               	'n.代表,委员,特派员');
insert into e6(word,meaning) value('deliberate',             	'a.深思熟虑的;审慎的');
insert into e6(word,meaning) value('deliberately',           	'ad.审慎地,故意地');
insert into e6(word,meaning) value('denial',                 	'n.否定;拒绝相信');
insert into e6(word,meaning) value('denote',                 	'vt.指示,意味着');
insert into e6(word,meaning) value('denounce',               	'vt.谴责,声讨;告发');
insert into e6(word,meaning) value('dentist',                	'n.牙科医生');
insert into e6(word,meaning) value('dependant',              	'n.受赡养者;侍从');
insert into e6(word,meaning) value('deposit',                	'n.押金;寄存物');
insert into e6(word,meaning) value('deposition',             	'n.免职,罢免;口供');
insert into e6(word,meaning) value('depression',             	'n.消沉;不景气萧条期');
insert into e6(word,meaning) value('deprive',                	'vt.夺去;使(人)失去');
insert into e6(word,meaning) value('deputy',                 	'n.代理人 a.副的');
insert into e6(word,meaning) value('derivation',             	'n.引出;起源;衍生');
insert into e6(word,meaning) value('descendant',             	'n.子孙,后裔;弟子');
insert into e6(word,meaning) value('descent',                	'n.下降;出身;斜坡');
insert into e6(word,meaning) value('desert',                 	'vt.遗弃;擅离(职守)');
insert into e6(word,meaning) value('designate',              	'vt.指出,指示;指定');
insert into e6(word,meaning) value('desolate',               	'a.荒芜的;孤独的');
insert into e6(word,meaning) value('dessert',                	'n.甜点心');
insert into e6(word,meaning) value('destine',                	'vt.命定,注定;预定');
insert into e6(word,meaning) value('destiny',                	'n.命运,天数');
insert into e6(word,meaning) value('destructive',            	'a.破坏(性)的,危害的');
insert into e6(word,meaning) value('detach',                 	'vt.分开;派遣(军队)');
insert into e6(word,meaning) value('detail',                 	'n.琐碎,小事');
insert into e6(word,meaning) value('detain',                 	'vt.耽搁;扣押,拘留');
insert into e6(word,meaning) value('detective',              	'n.侦探,密探');
insert into e6(word,meaning) value('detector',               	'n.发觉者,探测器');
insert into e6(word,meaning) value('develop',                	'vt.使(颜色等)显现');
insert into e6(word,meaning) value('deviate',                	'vt.(使)背离,偏离');
insert into e6(word,meaning) value('deviation',              	'n.背离,偏离;偏差数');
insert into e6(word,meaning) value('devotion',               	'n.献身,热诚,专心');
insert into e6(word,meaning) value('devour',                 	'vt.吞食;吞灭,毁灭');
insert into e6(word,meaning) value('diagnose',               	'vt.诊断(疾病)');
insert into e6(word,meaning) value('dictator',               	'n.独裁者,专政者');
insert into e6(word,meaning) value('diesel',                 	'n.柴油发动机,内燃机');
insert into e6(word,meaning) value('diet',                   	'n.饮食,食物');
insert into e6(word,meaning) value('difficult',              	'a.难以满足的');
insert into e6(word,meaning) value('dignity',                	'a.尊贵;(举止)庄严');
insert into e6(word,meaning) value('diminish',               	'vt.减少,减小,递减');
insert into e6(word,meaning) value('dine',                   	'vi.吃饭 vt.宴请');
insert into e6(word,meaning) value('dioxide',                	'n.二氧化物');
insert into e6(word,meaning) value('diploma',                	'n.毕业文凭,学位证书');
insert into e6(word,meaning) value('diplomatic',             	'a.外交的;有策略的');
insert into e6(word,meaning) value('directory',              	'n.姓名地址录;董事会');
insert into e6(word,meaning) value('disagreement',           	'n.不一致;争论');
insert into e6(word,meaning) value('disappearance',          	'n.消失,消散;失踪');
insert into e6(word,meaning) value('disastrous',             	'a.灾难性的;悲惨的');
insert into e6(word,meaning) value('discern',                	'vt.看出,辨出;辨别');
insert into e6(word,meaning) value('discount',               	'n.折扣;打折扣卖');
insert into e6(word,meaning) value('discourse',              	'n.讲话,演说,讲道');
insert into e6(word,meaning) value('discrimination',         	'n.辨别;识别力;歧视');
insert into e6(word,meaning) value('disgrace',               	'n.失宠,耻辱,丢脸');
insert into e6(word,meaning) value('disillusion',            	'n.觉醒 vt.使觉醒');
insert into e6(word,meaning) value('dismay',                 	'n.惊慌,沮丧,灰心');
insert into e6(word,meaning) value('dismiss',                	'vt.忘掉');
insert into e6(word,meaning) value('disorder',               	'n.疾病,小病');
insert into e6(word,meaning) value('dispatch',               	'vt.派遣;调度 n.急件');
insert into e6(word,meaning) value('disperse',               	'vt.(使)分散;驱散');
insert into e6(word,meaning) value('displace',               	'vt.移置;取代;置换');
insert into e6(word,meaning) value('displacement',           	'n.移置;免职;置换');
insert into e6(word,meaning) value('disregard',              	'vt.不管,不顾 n.不管');
insert into e6(word,meaning) value('dissatisfaction',        	'n.不满,不平');
insert into e6(word,meaning) value('dissipate',              	'vt.驱散;浪费vi.消散');
insert into e6(word,meaning) value('dissolve',               	'vt.解除(婚约等)');
insert into e6(word,meaning) value('distinct',               	'a.独特的');
insert into e6(word,meaning) value('distinctly',             	'ad.显然,清楚地');
insert into e6(word,meaning) value('distinguish',            	'v.使显出特色,使杰出');
insert into e6(word,meaning) value('distort',                	'vt.歪曲,曲解,扭曲');
insert into e6(word,meaning) value('distortion',             	'n.弄歪,歪曲;畸变');
insert into e6(word,meaning) value('distract',               	'vt.分散(心思);打扰');
insert into e6(word,meaning) value('disturbance',            	'n.动乱;干扰;侵犯');
insert into e6(word,meaning) value('diverge',                	'vi.分岔;分歧');
insert into e6(word,meaning) value('diversion',              	'n.转移;改道;娱乐');
insert into e6(word,meaning) value('divert',                 	'vt.使转向 vi.转移');
insert into e6(word,meaning) value('divine',                 	'a.神的;敬神的');
insert into e6(word,meaning) value('dizzy',                  	'a.头晕眼花的,眩晕的');
insert into e6(word,meaning) value('dock',                   	'vt.把…引入船坞');
insert into e6(word,meaning) value('doctrine',               	'n.教义,主义;学说');
insert into e6(word,meaning) value('documentary',            	'a.纪录的,文献的');
insert into e6(word,meaning) value('dome',                   	'n.圆屋顶,拱顶');
insert into e6(word,meaning) value('domestic',               	'a.养在家里的');
insert into e6(word,meaning) value('dominant',               	'a.统治的 n.主因');
insert into e6(word,meaning) value('dominate',               	'vt.统治,支配,控制');
insert into e6(word,meaning) value('doom',                   	'n.命运,毁灭 vt.注定');
insert into e6(word,meaning) value('doubtless',              	'ad.无疑地;很可能');
insert into e6(word,meaning) value('dove',                   	'n.鸽子,斑鸠');
insert into e6(word,meaning) value('drain',                  	'vi.(水等)流掉');
insert into e6(word,meaning) value('drainage',               	'n.排水;下水道');
insert into e6(word,meaning) value('drama',                  	'n.戏剧性事件;戏剧性');
insert into e6(word,meaning) value('drastic',                	'a.激烈的;严厉的');
insert into e6(word,meaning) value('drawback',               	'n.退款;妨碍;弊端');
insert into e6(word,meaning) value('dreadful',               	'a.可怕的;令人敬畏的');
insert into e6(word,meaning) value('dry',                    	'a.干巴巴的,枯燥的');
insert into e6(word,meaning) value('duke',                   	'n.公爵,君主;手');
insert into e6(word,meaning) value('duplicate',              	'n.复制品 vt.复制');
insert into e6(word,meaning) value('dust',                   	'n.垃圾,废品,灰烬');
insert into e6(word,meaning) value('dwarf',                  	'n.矮子,侏儒');
insert into e6(word,meaning) value('dwell',                  	'n.居住 vi.凝思,细想');
insert into e6(word,meaning) value('dynamic(al)','a.机能上的');
insert into e6(word,meaning) value('dynamo',                 	'n.发电机');
insert into e6(word,meaning) value('ear',                    	'n.(稻麦等的)穗');
insert into e6(word,meaning) value('earnings',               	'n.工资,收入;收益');
insert into e6(word,meaning) value('earthenware',            	'n.陶器');
insert into e6(word,meaning) value('eastward',               	'a.&ad.向东的,向东');
insert into e6(word,meaning) value('echo',                   	'vt.反射(声音等)');
insert into e6(word,meaning) value('eclipse',                	'n.(日,月)食');
insert into e6(word,meaning) value('ecology',                	'n.生态学;个体生态学');
insert into e6(word,meaning) value('economically',           	'ad.节约地,在经济上');
insert into e6(word,meaning) value('economics',              	'n.经济学;经济');
insert into e6(word,meaning) value('edit',                   	'vt.编辑,编纂;校订');
insert into e6(word,meaning) value('editorial',              	'n.社论,期刊的社论');
insert into e6(word,meaning) value('Egyptian',               	'a.埃及的 n.埃及人');
insert into e6(word,meaning) value('eject',                  	'vt.逐出,排斥;喷射');
insert into e6(word,meaning) value('elapse',                 	'vi.(时间)过去,消逝');
insert into e6(word,meaning) value('elbow',                  	'vt.用肘挤,挤进');
insert into e6(word,meaning) value('electrician',            	'n.电工,电气技师');
insert into e6(word,meaning) value('electrode',              	'n.电极;电焊条');
insert into e6(word,meaning) value('electronics',            	'n.电子学');
insert into e6(word,meaning) value('elegant',                	'a.(举止、服饰)雅致的');
insert into e6(word,meaning) value('elemental',              	'a.基本的;自然力的');
insert into e6(word,meaning) value('elevate',                	'vt.提高(思想);抬高');
insert into e6(word,meaning) value('elevation',              	'n.高度;标高;隆肿');
insert into e6(word,meaning) value('elliptical',             	'a.椭圆的;省略的');
insert into e6(word,meaning) value('eloquence',              	'n.雄辩;口才,修辞');
insert into e6(word,meaning) value('embarrass',              	'vt.使负债;使复杂化');
insert into e6(word,meaning) value('embassy',                	'n.大使馆;大使的职务');
insert into e6(word,meaning) value('embody',                 	'vt.体现;包含,收录');
insert into e6(word,meaning) value('embrace',                	'vt.包括,包含;包围');
insert into e6(word,meaning) value('embroidery',             	'n.绣花,刺绣;绣制品');
insert into e6(word,meaning) value('emerge',                 	'vi.浮现,出现;显露');
insert into e6(word,meaning) value('emigrate',               	'vi.永久移居国外');
insert into e6(word,meaning) value('emission',               	'n.散发;传播;发出物');
insert into e6(word,meaning) value('empirical',              	'a.经验主义的');
insert into e6(word,meaning) value('enchant',                	'vt.迷住;用魔法迷惑');
insert into e6(word,meaning) value('enclosure',              	'n.围绕;围场,围栏');
insert into e6(word,meaning) value('end',                    	'n.目标,目的');
insert into e6(word,meaning) value('endanger',               	'vt.危及,危害');
insert into e6(word,meaning) value('endeavor',               	'vi.&n.努力,尽力');
insert into e6(word,meaning) value('endow',                  	'vt.资助;赋予,授予');
insert into e6(word,meaning) value('endurance',              	'n.耐久力,持久力');
insert into e6(word,meaning) value('energetic',              	'a.积极的;精力旺盛的');
insert into e6(word,meaning) value('energize',               	'vt.给与…能量;电压');
insert into e6(word,meaning) value('engage',                 	'vt.使(齿轮等)啮合');
insert into e6(word,meaning) value('engagement',             	'n.婚约;约会,债务');
insert into e6(word,meaning) value('enhance',                	'vt.提高,增加;夸张');
insert into e6(word,meaning) value('enlighten',              	'vt.启发,开导;启蒙');
insert into e6(word,meaning) value('enrich',                 	'vt.使富裕;使丰富');
insert into e6(word,meaning) value('enroll',                 	'vt.登记,招收vi.参军');
insert into e6(word,meaning) value('enterprise',             	'n.艰巨的事业;事业心');
insert into e6(word,meaning) value('entertainment',          	'n.招待,招待会');
insert into e6(word,meaning) value('entitle',                	'vt.把…称作');
insert into e6(word,meaning) value('entreat',                	'vt.&vi.恳求');
insert into e6(word,meaning) value('entry',                  	'n.通道;条目');
insert into e6(word,meaning) value('environmental',          	'a.环境的,环境产生的');
insert into e6(word,meaning) value('episode',                	'n.一段情节;插曲');
insert into e6(word,meaning) value('epoch',                  	'n.(新)时代;历元');
insert into e6(word,meaning) value('equation',               	'n.平衡;平均;反应式');
insert into e6(word,meaning) value('equator',                	'n.赤道,天球赤道');
insert into e6(word,meaning) value('equilibrium',            	'n.平衡,均衡;均衡论');
insert into e6(word,meaning) value('equivalent',             	'a.等面(体)积的');
insert into e6(word,meaning) value('erect',                  	'a.竖起的');
insert into e6(word,meaning) value('erosion',                	'n.腐蚀,侵蚀;糜烂');
insert into e6(word,meaning) value('errand',                 	'n.差使,差事');
insert into e6(word,meaning) value('escort',                 	'n.&vt.护卫,护送');
insert into e6(word,meaning) value('essence',                	'n.本质,本体;精华');
insert into e6(word,meaning) value('essential',              	'a.特发的;自发的');
insert into e6(word,meaning) value('establish',              	'vt.使…被永久地接受');
insert into e6(word,meaning) value('estate',                 	'n.房地产;财产,产业');
insert into e6(word,meaning) value('eternal',                	'n.永久的;不朽的');
insert into e6(word,meaning) value('evaporate',              	'vt.使脱水vi.发散蒸气');
insert into e6(word,meaning) value('even',                   	'a.同一日期的');
insert into e6(word,meaning) value('evenly',                 	'ad.一致地,平静地');
insert into e6(word,meaning) value('everlasting',            	'a.永久的;持久的');
insert into e6(word,meaning) value('evil',                   	'n.邪恶,罪恶;祸害');
insert into e6(word,meaning) value('evolution',              	'n.开方;(天体的)形成');
insert into e6(word,meaning) value('excel',                  	'vt.胜过 vi.杰出');
insert into e6(word,meaning) value('except',                 	'vt.把…除外,除去');
insert into e6(word,meaning) value('exceptional',            	'a.例外的;优越的');
insert into e6(word,meaning) value('excess',                 	'n.过度行为,暴行');
insert into e6(word,meaning) value('excessively',            	'ad.过分,极端地');
insert into e6(word,meaning) value('exclamation',            	'n.呼喊,惊叫;感叹');
insert into e6(word,meaning) value('exclusive',              	'a.除外的;孤傲的');
insert into e6(word,meaning) value('excursion',              	'n.离题');
insert into e6(word,meaning) value('excuse',                 	'vt.与…辩解;使免除');
insert into e6(word,meaning) value('execution',              	'n.实行,执行;处死刑');
insert into e6(word,meaning) value('executive',              	'n.总经理,董事');
insert into e6(word,meaning) value('exemplify',              	'vt.举例证明(解释)');
insert into e6(word,meaning) value('exert',                  	'vt.发挥(威力),施加');
insert into e6(word,meaning) value('exile',                  	'vt.流放 n.被流放者');
insert into e6(word,meaning) value('expect',                 	'vt.料想,认为');
insert into e6(word,meaning) value('expedition',             	'n.探险;探险队');
insert into e6(word,meaning) value('expenditure',            	'n.(时间等)支出,消费');
insert into e6(word,meaning) value('expel',                  	'vt.驱逐,开除;排出');
insert into e6(word,meaning) value('experimentally',         	'ad.实验上,实验性地');
insert into e6(word,meaning) value('experimentation',        	'n.实验,试验;实验法');
insert into e6(word,meaning) value('expire',                 	'vi.满期,到期;断气');
insert into e6(word,meaning) value('explicit',               	'a.明晰的;直率的');
insert into e6(word,meaning) value('exploration',            	'n.考察;勘探;探查');
insert into e6(word,meaning) value('exposition',             	'n.说明,解释;陈列');
insert into e6(word,meaning) value('extinct',                	'a.绝种的;熄灭了的');
insert into e6(word,meaning) value('extinguish',             	'vt.熄灭,扑灭;消灭');
insert into e6(word,meaning) value('extra',                  	'n.附加物;额外的人手');
insert into e6(word,meaning) value('extract',                	'vt.取出;榨取 n.摘录');
insert into e6(word,meaning) value('extraction',             	'n.抽出;提取法;摘要');
insert into e6(word,meaning) value('extraordinarily',        	'ad.非常地,特别地');
insert into e6(word,meaning) value('extravagant',            	'a.奢侈的;过度的');
insert into e6(word,meaning) value('extreme',                	'n.极端不同的性质');
insert into e6(word,meaning) value('fabricate',              	'vt.制作,组合;捏造');
insert into e6(word,meaning) value('fabrication',            	'n.制作,构成;捏造');
insert into e6(word,meaning) value('facilitate',             	'vt.使容易;助长');
insert into e6(word,meaning) value('faction',                	'n.派别,宗派,小集团');
insert into e6(word,meaning) value('fair',                   	'a.美丽的');
insert into e6(word,meaning) value('fake',                   	'n.假货,膺品 a.假的');
insert into e6(word,meaning) value('fall',                   	'vi.变成,成为;陷于');
insert into e6(word,meaning) value('fantastic',              	'a.空想的;奇异的');
insert into e6(word,meaning) value('fascinate',              	'vt.迷住 vi.迷人');
insert into e6(word,meaning) value('fastener',               	'n.扣件,钮扣,揿钮');
insert into e6(word,meaning) value('faultless',              	'a.无过失的;无缺点的');
insert into e6(word,meaning) value('fearless',               	'a.无畏的,大胆的');
insert into e6(word,meaning) value('feel',                   	'vi.摸起来');
insert into e6(word,meaning) value('fell',                   	'vt.砍倒(树等);砍伐');
insert into e6(word,meaning) value('fellowship',             	'n.伙伴关系;联谊会');
insert into e6(word,meaning) value('feminine',               	'a.女性的;女子气的');
insert into e6(word,meaning) value('fence',                  	'n.击剑(术) vi.击剑');
insert into e6(word,meaning) value('ferrous',                	'a.铁的;亚铁的');
insert into e6(word,meaning) value('ferry',                  	'n.渡船;渡口 vt.运送');
insert into e6(word,meaning) value('fertile',                	'a.(创造力)丰富的');
insert into e6(word,meaning) value('fighter',                	'n.斗争者;战斗机');
insert into e6(word,meaning) value('filament',               	'n.细丝;长丝;灯丝');
insert into e6(word,meaning) value('fill',                   	'vt.担任(职务);填补');
insert into e6(word,meaning) value('filter',                 	'vi.滤过');
insert into e6(word,meaning) value('filth',                  	'n.污秽,污物;淫猥');
insert into e6(word,meaning) value('finance',                	'vt.提供资金');
insert into e6(word,meaning) value('finely',                 	'ad.精细地,美好地');
insert into e6(word,meaning) value('finite',                 	'a.有限的;有尽的');
insert into e6(word,meaning) value('fireplace',              	'n.壁炉');
insert into e6(word,meaning) value('firework',               	'n.爆竹,花炮,烟火');
insert into e6(word,meaning) value('firmness',               	'n.坚固,坚定,稳固');
insert into e6(word,meaning) value('first-rate',             	'a.第一流的,优秀的');
insert into e6(word,meaning) value('fission',                	'n.裂开;分裂生殖');
insert into e6(word,meaning) value('fitness',                	'n.适当,恰当;健康');
insert into e6(word,meaning) value('fitting',                	'a.适当的 n.配合');
insert into e6(word,meaning) value('fixture',                	'n.固定;定期存款');
insert into e6(word,meaning) value('flake',                  	'n.片,薄片;肌膈');
insert into e6(word,meaning) value('flame',                  	'vi.发火焰 vt.点燃');
insert into e6(word,meaning) value('flank',                  	'n.肋,肋腹;侧面');
insert into e6(word,meaning) value('flannel',                	'n.法兰绒;法兰绒衣服');
insert into e6(word,meaning) value('flap',                   	'vt.&n.拍打 vi.拍动');
insert into e6(word,meaning) value('flask',                  	'n.瓶;火药筒;砂箱');
insert into e6(word,meaning) value('flatten',                	'vt.把…弄平;击倒');
insert into e6(word,meaning) value('flatter',                	'vt.奉承,阿谀,谄媚');
insert into e6(word,meaning) value('flavour',                	'vt.给…调味');
insert into e6(word,meaning) value('flaw',                   	'n.缺点,瑕疵;裂隙');
insert into e6(word,meaning) value('flee',                   	'vi.逃走 vt.逃避');
insert into e6(word,meaning) value('flexible',               	'a.灵活的,可变通的');
insert into e6(word,meaning) value('flight',                 	'n.溃退,逃跑;外流');
insert into e6(word,meaning) value('fling',                  	'vi.&vt.(用力)扔,抛');
insert into e6(word,meaning) value('float',                  	'n.漂浮物;浮标,木筏');
insert into e6(word,meaning) value('flock',                  	'vi.群集,聚集');
insert into e6(word,meaning) value('fluctuate',              	'vi.波动 vt.使波动');
insert into e6(word,meaning) value('fluctuation',            	'n.波动;脉动;踌躇');
insert into e6(word,meaning) value('flush',                  	'n.兴奋,脸红;发烧');
insert into e6(word,meaning) value('flutter',                	'vi.(鸟)振翼;飘动');
insert into e6(word,meaning) value('flux',                   	'n.流;涨潮;流量');
insert into e6(word,meaning) value('fly',                    	'v.飞跑,逃跑,消失');
insert into e6(word,meaning) value('foam',                   	'n.泡沫;泡沫塑料');
insert into e6(word,meaning) value('follow',                 	'vt.从事(职业),经营');
insert into e6(word,meaning) value('follower',               	'n.契据的附面;从动件');
insert into e6(word,meaning) value('footpath',               	'n.小路,人行道');
insert into e6(word,meaning) value('fore',                   	'ad.在前面 a.先前的');
insert into e6(word,meaning) value('foreign',                	'a.无关的');
insert into e6(word,meaning) value('foresee',                	'vt.预见,预知,看穿');
insert into e6(word,meaning) value('forge',                  	'vt.打(铁等),锻造');
insert into e6(word,meaning) value('formal',                 	'a.形态的;规范的');
insert into e6(word,meaning) value('formerly',               	'ad.以前,从前');
insert into e6(word,meaning) value('formidable',             	'a.可怕的;难对付的');
insert into e6(word,meaning) value('formulate',              	'vt.用公式表示');
insert into e6(word,meaning) value('formulation',            	'n.明确的表达');
insert into e6(word,meaning) value('forsake',                	'vt.遗弃,抛弃,摒绝');
insert into e6(word,meaning) value('fort',                   	'n.要塞,堡垒');
insert into e6(word,meaning) value('forthcoming',            	'a.即将到来的;现有的');
insert into e6(word,meaning) value('fortress',               	'n.堡垒,要塞');
insert into e6(word,meaning) value('forum',                  	'n.论坛,讨论会');
insert into e6(word,meaning) value('forward',                	'ad.向前,将来vt.转递');
insert into e6(word,meaning) value('fossil',                 	'n.化石 a.化石的');
insert into e6(word,meaning) value('foster',                 	'vt.养育,抚养;培养');
insert into e6(word,meaning) value('foul',                   	'a.肮脏的;丑恶的');
insert into e6(word,meaning) value('fowl',                   	'n.家禽;禽肉');
insert into e6(word,meaning) value('fraction',               	'n.分数;分馏的部分');
insert into e6(word,meaning) value('fracture',               	'n.破裂;裂痕 vi.破裂');
insert into e6(word,meaning) value('fragile',                	'a.脆的;体质弱的');
insert into e6(word,meaning) value('fragrant',               	'a.香的,芬芳的');
insert into e6(word,meaning) value('frail',                  	'a.脆弱的;意志薄弱的');
insert into e6(word,meaning) value('framework',              	'n.机构,组织,体制');
insert into e6(word,meaning) value('freight',                	'n.运费;货运;负担');
insert into e6(word,meaning) value('frequency',              	'n.频繁,屡次;频率');
insert into e6(word,meaning) value('frequent',               	'a.常见的;频繁的');
insert into e6(word,meaning) value('freshen',                	'vt.使显得新鲜');
insert into e6(word,meaning) value('fret',                   	'vt.&vi.(使)烦恼');
insert into e6(word,meaning) value('friction',               	'n.擦热皮肤');
insert into e6(word,meaning) value('fright',                 	'n.惊吓,恐怖');
insert into e6(word,meaning) value('frightful',              	'a.可怕的;讨厌的');
insert into e6(word,meaning) value('fringe',                 	'n.穗,毛边;边缘');
insert into e6(word,meaning) value('fro',                    	'ad.往,去,回,向后');
insert into e6(word,meaning) value('frock',                  	'n.(女)上衣,罩衫');
insert into e6(word,meaning) value('frustrate',              	'vt.挫败;使无效');
insert into e6(word,meaning) value('furious',                	'a.狂暴的;强烈的');
insert into e6(word,meaning) value('further',                	'vt.增进');
insert into e6(word,meaning) value('fury',                   	'n.狂怒,暴怒;猛烈');
insert into e6(word,meaning) value('fuse',                   	'n.保险丝,导火线');
insert into e6(word,meaning) value('fuss',                   	'n.忙乱;吹捧 vi.忙乱');
insert into e6(word,meaning) value('gamble',                 	'n.赌博 vt.冒…的险');
insert into e6(word,meaning) value('gangster',               	'n.匪徒,歹徒,暴徒');
insert into e6(word,meaning) value('gap',                    	'n.山口,山峡;差距');
insert into e6(word,meaning) value('garage',                 	'n.汽车修理站;飞机库');
insert into e6(word,meaning) value('garlic',                 	'n.蒜,大蒜');
insert into e6(word,meaning) value('garment',                	'n.衣服;服装,衣着');
insert into e6(word,meaning) value('gather',                 	'vt.推测,推断');
insert into e6(word,meaning) value('gathering',              	'n.集会,聚会,聚集');
insert into e6(word,meaning) value('gear',                   	'n.齿轮,传动装置');
insert into e6(word,meaning) value('generalization',         	'n.一般化;概括,综合');
insert into e6(word,meaning) value('generalize',             	'vt.概括出vi.形成概念');
insert into e6(word,meaning) value('generate',               	'vt.发生,产生;生成');
insert into e6(word,meaning) value('generosity',             	'n.慷慨,宽宏大量');
insert into e6(word,meaning) value('geographical',           	'a.地理的;地区(性)的');
insert into e6(word,meaning) value('geology',                	'n.地质学;(某地)地质');
insert into e6(word,meaning) value('geometrical',            	'a.几何学的');
insert into e6(word,meaning) value('germ',                   	'n.细菌,病原菌;幼芽');
insert into e6(word,meaning) value('gesture',                	'vi.(讲话时等)做手势');
insert into e6(word,meaning) value('gigantic',               	'a.巨大的;巨人似的');
insert into e6(word,meaning) value('ginger',                 	'n.姜,生姜');
insert into e6(word,meaning) value('gleam',                  	'n.微光 vi.发微光');
insert into e6(word,meaning) value('glider',                 	'n.滑翔机;滑翔导弹');
insert into e6(word,meaning) value('global',                 	'a.球面的;全球的');
insert into e6(word,meaning) value('glorify',                	'vt.赞美(上帝);颂扬');
insert into e6(word,meaning) value('glossary',               	'n.词汇表;术语汇编');
insert into e6(word,meaning) value('glue',                   	'vt.粘牢');
insert into e6(word,meaning) value('gnaw',                   	'vt.啃,咬断 vi.啮');
insert into e6(word,meaning) value('goddess',                	'n.女神;绝世美女');
insert into e6(word,meaning) value('goodness',               	'n.善良,善行,美德');
insert into e6(word,meaning) value('gorilla',                	'n.大猩猩;暴徒,打手');
insert into e6(word,meaning) value('gorgeous',               	'a.绚丽的;极好的');
insert into e6(word,meaning) value('gossip',                 	'n.闲谈;碎嘴子;漫笔');
insert into e6(word,meaning) value('govern',                 	'vt.决定,支配;控制');
insert into e6(word,meaning) value('grab',                   	'vt.&vi.攫取,抓取');
insert into e6(word,meaning) value('gracious',               	'a.谦和的');
insert into e6(word,meaning) value('gradient',               	'n.斜坡 a.倾斜的');
insert into e6(word,meaning) value('gramophone',             	'n.留声机');
insert into e6(word,meaning) value('granite',                	'a.花岗岩,花岗石');
insert into e6(word,meaning) value('grant',                  	'n.授予物,拨款');
insert into e6(word,meaning) value('graphite',               	'n.石墨,石墨电极');
insert into e6(word,meaning) value('grasshopper',            	'n.蚱蜢,蝗虫,蚂蚱');
insert into e6(word,meaning) value('grassy',                 	'a.草多的;草似的');
insert into e6(word,meaning) value('grateful',               	'a.可喜的,令人愉快的');
insert into e6(word,meaning) value('gravel',                 	'n.砂跞;砂砾层;结石');
insert into e6(word,meaning) value('graze',                  	'vi.喂草;放牧(牲畜)');
insert into e6(word,meaning) value('grease',                 	'n.动物脂,脂肪');
insert into e6(word,meaning) value('greed',                  	'n.贪心,贪婪');
insert into e6(word,meaning) value('grief',                  	'n.悲哀,悲痛,悲伤');
insert into e6(word,meaning) value('grim',                   	'a.冷酷无情的,严厉的');
insert into e6(word,meaning) value('grin',                   	'vi.咧着嘴笑');
insert into e6(word,meaning) value('grind',                  	'vt.折磨,压榨');
insert into e6(word,meaning) value('groove',                 	'n.槽 vt.开槽于');
insert into e6(word,meaning) value('grope',                  	'vi.(暗中)摸索,探索');
insert into e6(word,meaning) value('gross',                  	'a.(语言、举止)粗俗的');
insert into e6(word,meaning) value('grove',                  	'n.林子,小树林,园林');
insert into e6(word,meaning) value('growl',                  	'vi.(狗等)嗥叫;咆哮');
insert into e6(word,meaning) value('grumble',                	'vi.抱怨,发牢骚');
insert into e6(word,meaning) value('grunt',                  	'vi.作呼噜声;咕哝');
insert into e6(word,meaning) value('guilt',                  	'n.有罪,犯罪;内疚');
insert into e6(word,meaning) value('guitar',                 	'n.吉他,六弦琴');
insert into e6(word,meaning) value('gust',                   	'n.阵风,一阵狂风');
insert into e6(word,meaning) value('gutter',                 	'n.沟,边沟;檐槽');
insert into e6(word,meaning) value('hail',                   	'vt.向…欢呼 vi.招呼');
insert into e6(word,meaning) value('halve',                  	'vt.对分;平摊');
insert into e6(word,meaning) value('ham',                    	'n.火腿;(兽类的)后踝');
insert into e6(word,meaning) value('hamper',                 	'vt.妨碍,阻碍,牵制');
insert into e6(word,meaning) value('handbook',               	'n.手册,便览,指南');
insert into e6(word,meaning) value('handicap',               	'vt.妨碍,使不利');
insert into e6(word,meaning) value('handout',                	'n.施舍物,救济品');
insert into e6(word,meaning) value('handy',                  	'a.方便的;便于使用的');
insert into e6(word,meaning) value('harbour',                	'vt.隐匿,窝藏;怀着');
insert into e6(word,meaning) value('hard',                   	'a.(酒)烈性的');
insert into e6(word,meaning) value('hardy',                  	'a.强壮的,耐劳的');
insert into e6(word,meaning) value('harmonious',             	'a.和谐的,协调的');
insert into e6(word,meaning) value('harp',                   	'n.竖琴;天琴座');
insert into e6(word,meaning) value('harsh',                  	'a.粗糙的;严厉的');
insert into e6(word,meaning) value('hatch',                  	'vt.舱盖,舱口;短门');
insert into e6(word,meaning) value('haughty',                	'a.傲慢的,轻蔑的');
insert into e6(word,meaning) value('haul',                   	'vt.拖曳;拖运');
insert into e6(word,meaning) value('haunt',                  	'vt.常去 vi.经常出没');
insert into e6(word,meaning) value('hazard',                 	'vt.使遭危险 n.危险');
insert into e6(word,meaning) value('head',                   	'vt.用头顶(球)vi.出发');
insert into e6(word,meaning) value('heading',                	'n.标题,题词,题名');
insert into e6(word,meaning) value('headlong',               	'a.&ad.头向前的(地)');
insert into e6(word,meaning) value('headquarters',           	'n.总局,总店');
insert into e6(word,meaning) value('hearth',                 	'n.壁炉地面;炉边');
insert into e6(word,meaning) value('heater',                 	'n.加热的人,加热器');
insert into e6(word,meaning) value('hearty',                 	'a.衷心的;丰盛的');
insert into e6(word,meaning) value('heave',                  	'vt.(用力地)举起;抛');
insert into e6(word,meaning) value('Heaven',                 	'n.上帝,神');
insert into e6(word,meaning) value('heighten',               	'vt.加高,提高;增加');
insert into e6(word,meaning) value('hemisphere',             	'n.半球;半球地图');
insert into e6(word,meaning) value('henceforth',             	'ad.今后,从今以后');
insert into e6(word,meaning) value('herald',                 	'ad.传令官;通报者');
insert into e6(word,meaning) value('herb',                   	'n.草本植物;香草');
insert into e6(word,meaning) value('herd',                   	'vt.放牧 vi.成群');
insert into e6(word,meaning) value('hesitate',               	'vi.含糊,支吾;口吃');
insert into e6(word,meaning) value('hide',                   	'n.生皮,兽皮,皮革');
insert into e6(word,meaning) value('hike',                   	'vi.作长途徒步旅行');
insert into e6(word,meaning) value('hindrance',              	'n.障碍,妨碍');
insert into e6(word,meaning) value('hinge',                  	'n.合页,折叶,铰链');
insert into e6(word,meaning) value('hip',                    	'n.臀部,髋;屋脊');
insert into e6(word,meaning) value('hiss',                   	'n.嘶嘶声 vi.嘶嘶作声');
insert into e6(word,meaning) value('historian',              	'n.历史学家;编史家');
insert into e6(word,meaning) value('historic',               	'a.历史的;历史性的');
insert into e6(word,meaning) value('hit',                    	'n.轰动一时的人(或事)');
insert into e6(word,meaning) value('hitherto',               	'ad.迄今,到目前为止');
insert into e6(word,meaning) value('hoarse',                 	'a.(声音)嘶哑的');
insert into e6(word,meaning) value('hoe',                    	'vt.&vi.锄地');
insert into e6(word,meaning) value('hoist',                  	'vt.升起 vi.扯起来');
insert into e6(word,meaning) value('hollow',                 	'vt.凿空 vi.变空');
insert into e6(word,meaning) value('homely',                 	'a.家庭的;家常的');
insert into e6(word,meaning) value('homogeneous',            	'a.同类的;均匀的');
insert into e6(word,meaning) value('hook',                   	'vt.用钩连接,用钩挂');
insert into e6(word,meaning) value('hop',                    	'vi.跳舞;(人)单足跳');
insert into e6(word,meaning) value('horizon',                	'n.层位');
insert into e6(word,meaning) value('horn',                   	'n.角状物,角制品');
insert into e6(word,meaning) value('hose',                   	'n.长筒袜;软管');
insert into e6(word,meaning) value('hospitality',            	'n.好客,殷勤;宜人');
insert into e6(word,meaning) value('hostage',                	'n.人质,抵押品');
insert into e6(word,meaning) value('hostess',                	'n.女主人;旅馆女老板');
insert into e6(word,meaning) value('hostile',                	'a.敌对的;不友好的');
insert into e6(word,meaning) value('hound',                  	'n.狗;角鲨;卑鄙的人');
insert into e6(word,meaning) value('house',                  	'n.议院,会议厅');
insert into e6(word,meaning) value('hover',                  	'vi.徘徊;傍徨;翱翔');
insert into e6(word,meaning) value('howl',                   	'n.嚎叫;哀号 vi.吠');
insert into e6(word,meaning) value('hug',                    	'vt.搂 n.紧紧拥抱');
insert into e6(word,meaning) value('hull',                   	'n.外壳,豆荚;薄膜');
insert into e6(word,meaning) value('hum',                    	'n.嗡嗡声 vt.哼曲子');
insert into e6(word,meaning) value('humanitarian',           	'a.博爱的 n.慈善家');
insert into e6(word,meaning) value('humanity',               	'n.人类;人性,人情');
insert into e6(word,meaning) value('humidity',               	'n.湿气;湿度');
insert into e6(word,meaning) value('hurl',                   	'vt.猛投 vi.猛冲');
insert into e6(word,meaning) value('hurrah',                 	'int.好哇,万岁,乌拉');
insert into e6(word,meaning) value('hurricane',              	'n.飓风,十二级风');
insert into e6(word,meaning) value('hurt',                   	'n.损伤,伤害,创伤');
insert into e6(word,meaning) value('hush',                   	'n.沉默 int.嘘！');
insert into e6(word,meaning) value('hydraulic',              	'a.水力的;水力学的');
insert into e6(word,meaning) value('hydrocarbon',            	'n.烃,碳氢化合物');
insert into e6(word,meaning) value('hymn',                   	'n.赞美诗,圣歌;赞歌');
insert into e6(word,meaning) value('hypothesis',             	'n.假设;前提');
insert into e6(word,meaning) value('ice',                    	'vt.使成冰 vi.结冰');
insert into e6(word,meaning) value('icy',                    	'a.冰冷的;冷冰冰的');
insert into e6(word,meaning) value('idealism',               	'n.唯心主义;理想主义');
insert into e6(word,meaning) value('ideally',                	'ad.理想地;理论上');
insert into e6(word,meaning) value('identical',              	'a.同一的;恒等的');
insert into e6(word,meaning) value('identification',         	'n.认出,鉴定;身份证');
insert into e6(word,meaning) value('idiot',                  	'n.白痴;傻子');
insert into e6(word,meaning) value('idleness',               	'n.懒惰;赋闲无事');
insert into e6(word,meaning) value('ignite',                 	'vt.引燃 vi.着火');
insert into e6(word,meaning) value('ignorance',              	'n.无知,无学,愚昧');
insert into e6(word,meaning) value('illiterate',             	'a.文盲的 n.文盲');
insert into e6(word,meaning) value('illuminate',             	'vt.照明,照亮;阐明');
insert into e6(word,meaning) value('illusion',               	'n.幻想;错觉;假象');
insert into e6(word,meaning) value('imitation',              	'n.仿制品,伪制物');
insert into e6(word,meaning) value('immerse',                	'vt.沉浸;给…施洗礼');
insert into e6(word,meaning) value('immigrate',              	'vt.(使)移居入境');
insert into e6(word,meaning) value('immortal',               	'a.不朽的;永生的');
insert into e6(word,meaning) value('impart',                 	'vt.给予,传递;告诉');
insert into e6(word,meaning) value('impartial',              	'a.公正的,无偏见的');
insert into e6(word,meaning) value('implement',              	'n.工具,服装 vt.贯彻');
insert into e6(word,meaning) value('implore',                	'vt.乞求,恳求,哀求');
insert into e6(word,meaning) value('impose',                 	'vi.利用;欺骗');
insert into e6(word,meaning) value('impress',                	'vt.盖印,在…打记号');
insert into e6(word,meaning) value('improper',               	'a.不适当的;不合理的');
insert into e6(word,meaning) value('impulse',                	'n.推动,冲力;冲动');
insert into e6(word,meaning) value('impurity',               	'n.不纯;杂质;不道德');
insert into e6(word,meaning) value('inaccessible',           	'a.达不到的,难接近的');
insert into e6(word,meaning) value('inaccurate',             	'a.不精密的,不准确的');
insert into e6(word,meaning) value('inadequate',             	'a.不充足的,不适当的');
insert into e6(word,meaning) value('inasmuch',               	'ad.因为,由于');
insert into e6(word,meaning) value('inaugurate',             	'vt.开始;使就职');
insert into e6(word,meaning) value('incapable',              	'a.无能力的;无资格的');
insert into e6(word,meaning) value('incense',                	'n.香,熏香;香气');
insert into e6(word,meaning) value('incidence',              	'n.发生,影响;入射');
insert into e6(word,meaning) value('incidentally',           	'ad.附带地;顺便提及');
insert into e6(word,meaning) value('inclination',            	'n.倾斜,点头;斜坡');
insert into e6(word,meaning) value('incline',                	'n.坡度');
insert into e6(word,meaning) value('inclusive',              	'a.包围住的;包括的');
insert into e6(word,meaning) value('incompatible',           	'a.不相容的');
insert into e6(word,meaning) value('incomplete',             	'a.不完全的,未完成的');
insert into e6(word,meaning) value('incorporate',            	'vt.结合,合并,收编');
insert into e6(word,meaning) value('incredible',             	'a.难以置信的,惊人的');
insert into e6(word,meaning) value('indefinite',             	'a.无限期的');
insert into e6(word,meaning) value('indicative',             	'a.指示的;陈述的');
insert into e6(word,meaning) value('indignation',            	'n.愤怒,愤慨,义愤');
insert into e6(word,meaning) value('indispensable',          	'a.必不可少的,必需的');
insert into e6(word,meaning) value('individual',             	'a.特殊的');
insert into e6(word,meaning) value('indoor',                 	'a.室内的;室内进行的');
insert into e6(word,meaning) value('induce',                 	'vt.劝诱;引起;感应');
insert into e6(word,meaning) value('induction',              	'n.就职;归纳推理');
insert into e6(word,meaning) value('indulge',                	'vt.放纵(感情)vi.纵情');
insert into e6(word,meaning) value('industrious',            	'a.勤劳的,勤奋的');
insert into e6(word,meaning) value('inertia',                	'n.惯性,惯量;无力');
insert into e6(word,meaning) value('inevitably',             	'ad.不可避免地');
insert into e6(word,meaning) value('infect',                 	'vt.使受影响');
insert into e6(word,meaning) value('infectious',             	'a.传染的;感染性的');
insert into e6(word,meaning) value('infer',                  	'vt.&vi.猜想,臆测');
insert into e6(word,meaning) value('inference',              	'n.推论;推断的结果');
insert into e6(word,meaning) value('inferior',               	'n.下级;晚辈,次品');
insert into e6(word,meaning) value('infinite',               	'n.无限;无穷(大)');
insert into e6(word,meaning) value('infinitely',             	'ad.无限地,无边地');
insert into e6(word,meaning) value('infinity',               	'n.大量,大宗;无穷大');
insert into e6(word,meaning) value('inflation',              	'n.通货膨胀,物价飞涨');
insert into e6(word,meaning) value('influence',              	'n.势力,权势');
insert into e6(word,meaning) value('ingenious',              	'a.机灵的;精巧制成的');
insert into e6(word,meaning) value('ingenuity',              	'n.机灵;设计新颖');
insert into e6(word,meaning) value('ingredient',             	'n.配料,成分');
insert into e6(word,meaning) value('inherent',               	'a.固有的,生来的');
insert into e6(word,meaning) value('initial',                	'a.词首的');
insert into e6(word,meaning) value('initially',              	'ad.最初,开始');
insert into e6(word,meaning) value('initiate',               	'vt.开始,创始;启蒙');
insert into e6(word,meaning) value('initiative',             	'a.创始的 n.第一步');
insert into e6(word,meaning) value('inject',                 	'vt.注射;注满;喷射');
insert into e6(word,meaning) value('inland',                 	'a.国内的;内地的');
insert into e6(word,meaning) value('inlet',                  	'n.进口,水湾 vt.引进');
insert into e6(word,meaning) value('innovation',             	'n.创新,改革,新设施');
insert into e6(word,meaning) value('innumerable',            	'a.无数的,数不清的');
insert into e6(word,meaning) value('inorganic',              	'a.无生物的;无机的');
insert into e6(word,meaning) value('input',                  	'vt.输入 n.输入');
insert into e6(word,meaning) value('insert',                 	'vi.(肌肉)附着');
insert into e6(word,meaning) value('insight',                	'n.洞察力,洞悉,见识');
insert into e6(word,meaning) value('insignificant',          	'a.无意义的;低微的');
insert into e6(word,meaning) value('insistent',              	'a.坚持的;逼人注意的');
insert into e6(word,meaning) value('inspector',              	'n.检查员;巡官');
insert into e6(word,meaning) value('inspiration',            	'n.灵感;妙想;鼓舞');
insert into e6(word,meaning) value('instability',            	'n.不稳定性;不坚决');
insert into e6(word,meaning) value('installment',            	'n.分期付款');
insert into e6(word,meaning) value('instantaneous',          	'a.瞬间的,即刻的');
insert into e6(word,meaning) value('instructor',             	'n.指导者,教员');
insert into e6(word,meaning) value('instrumental',           	'a.仪器的;有帮助的');
insert into e6(word,meaning) value('insulate',               	'vt.使绝缘,使绝热');
insert into e6(word,meaning) value('insulator',              	'n.隔离者;绝缘体');
insert into e6(word,meaning) value('intake',                 	'n.吸入;输入能量');
insert into e6(word,meaning) value('integral',               	'a.组成的;整的');
insert into e6(word,meaning) value('integrate',              	'vt.使结合,使并入');
insert into e6(word,meaning) value('integrity',              	'n.诚实,正直');
insert into e6(word,meaning) value('intellect',              	'n.理智,智力,才智');
insert into e6(word,meaning) value('intent',                 	'a.目不转睛的,热切的');
insert into e6(word,meaning) value('interact',               	'vi.相互作用');
insert into e6(word,meaning) value('interconnect',           	'vt.使互相联系');
insert into e6(word,meaning) value('intercourse',            	'n.交际,往来,交流');
insert into e6(word,meaning) value('interface',              	'n.分界面');
insert into e6(word,meaning) value('interior',               	'n.内部 a.内部的');
insert into e6(word,meaning) value('intermediate',           	'n.中间体;调解人');
insert into e6(word,meaning) value('interpret',              	'vt.解释 vi.口译');
insert into e6(word,meaning) value('intervene',              	'vi.干涉,干预;播进');
insert into e6(word,meaning) value('interview',              	'vt.接见,会见,会谈');
insert into e6(word,meaning) value('intonation',             	'n.语调,声调;发声');
insert into e6(word,meaning) value('introduce',              	'vt.提出(议案等)');
insert into e6(word,meaning) value('invalid',                	'n.病人 a.有病的');
insert into e6(word,meaning) value('invariably',             	'ad.不变地,永恒地');
insert into e6(word,meaning) value('inversely',              	'ad.相反地');
insert into e6(word,meaning) value('invoice',                	'n.发票,发货清单');
insert into e6(word,meaning) value('ion',                    	'n.离子');
insert into e6(word,meaning) value('irregularity',           	'n.不规则;不整齐');
insert into e6(word,meaning) value('irrespective',           	'a.不考虑的,不顾的');
insert into e6(word,meaning) value('irrigation',             	'n.灌溉;冲洗法');
insert into e6(word,meaning) value('irritate',               	'vt.激怒;引起不愉快');
insert into e6(word,meaning) value('Islam',                  	'n.伊斯兰教,回教');
insert into e6(word,meaning) value('ivory',                  	'n.象牙;牙质;乳白色');
insert into e6(word,meaning) value('jack',                   	'n.起重器;传动装置');
insert into e6(word,meaning) value('jam',                    	'n.堵塞 vt.使…堵塞');
insert into e6(word,meaning) value('jealousy',               	'n.妒忌,嫉妒,猜忌');
insert into e6(word,meaning) value('jean',                   	'n.斜纹布,牛仔裤');
insert into e6(word,meaning) value('jelly',                  	'n.冻,果子冻;胶状物');
insert into e6(word,meaning) value('jerk',                   	'vt.猛地一拉 vi.急拉');
insert into e6(word,meaning) value('Jesus',                  	'n.耶稣');
insert into e6(word,meaning) value('jewellery',              	'n.珠宝,珠宝饰物');
insert into e6(word,meaning) value('jingle',                 	'vt.&vi.(使)丁当响');
insert into e6(word,meaning) value('jog',                    	'vt.使(马等)缓步行进');
insert into e6(word,meaning) value('jug',                    	'n.带柄水罐,大壶');
insert into e6(word,meaning) value('junction',               	'n.连接;接头;中继线');
insert into e6(word,meaning) value('jungle',                 	'n.丛林,密林,莽丛');
insert into e6(word,meaning) value('junior',                 	'n.年少者;晚辈');
insert into e6(word,meaning) value('Jupiter',                	'n.丘庇特;木星');
insert into e6(word,meaning) value('kernel',                 	'n.(果实的)核;谷粒');
insert into e6(word,meaning) value('kidnap',                 	'vt.诱拐,绑架');
insert into e6(word,meaning) value('kidney',                 	'n.肾,腰子;性格');
insert into e6(word,meaning) value('kilowatt',               	'n.千瓦(特)');
insert into e6(word,meaning) value('kindle',                 	'vt.点燃 vi.着火');
insert into e6(word,meaning) value('kinetic',                	'a.动力(学)的;活动的');
insert into e6(word,meaning) value('kit',                    	'n.成套工具;用具包');
insert into e6(word,meaning) value('knight',                 	'n.骑士,武士;爵士');
insert into e6(word,meaning) value('lace',                   	'vi.系带,用带子束紧');
insert into e6(word,meaning) value('landscape',              	'n.风景,景色,景致');
insert into e6(word,meaning) value('largely',                	'ad.大规模地');
insert into e6(word,meaning) value('late',                   	'a.去世不久的');
insert into e6(word,meaning) value('latent',                 	'a.存在但看不见的');
insert into e6(word,meaning) value('lathe',                  	'n.车床 vt.用车床加工');
insert into e6(word,meaning) value('latitude',               	'n.纬度;黄纬');
insert into e6(word,meaning) value('lattice',                	'n.格子;点阵,网络');
insert into e6(word,meaning) value('laundry',                	'n.送洗衣店去洗的东西');
insert into e6(word,meaning) value('leaflet',                	'n.传单,活页;广告');
insert into e6(word,meaning) value('leakage',                	'n.漏,泄漏;漏出物');
insert into e6(word,meaning) value('lease',                  	'n.租约,契约,租契');
insert into e6(word,meaning) value('legislation',            	'n.立法;法规');
insert into e6(word,meaning) value('length',                 	'n.程度,范围');
insert into e6(word,meaning) value('lengthen',               	'vt.使延长 vi.变长');
insert into e6(word,meaning) value('leopard',                	'n.豹');
insert into e6(word,meaning) value('lessen',                 	'vt.减少 vi.变少');
insert into e6(word,meaning) value('lever',                  	'n.途径,工具,手段');
insert into e6(word,meaning) value('liability',              	'n.责任;倾向;债务');
insert into e6(word,meaning) value('liable',                 	'a.有(法律)责任的');
insert into e6(word,meaning) value('lighter',                	'n.打火机,引燃器');
insert into e6(word,meaning) value('likelihood',             	'n.可能(性)');
insert into e6(word,meaning) value('likeness',               	'n.同样;类似,相似');
insert into e6(word,meaning) value('lily',                   	'n.百合,百合花,睡莲');
insert into e6(word,meaning) value('limb',                   	'n.分支,突出物');
insert into e6(word,meaning) value('limestone',              	'n.石灰石');
insert into e6(word,meaning) value('limp',                   	'vi.蹒跚,跛行 n.跛行');
insert into e6(word,meaning) value('line',                   	'vt.加衬里于');
insert into e6(word,meaning) value('linear',                 	'a.线的;长度的');
insert into e6(word,meaning) value('liner',                  	'n.班船,定期班机');
insert into e6(word,meaning) value('linger',                 	'vi.逗留,徘徊;拖延');
insert into e6(word,meaning) value('lining',                 	'n.(衣服里的)衬里');
insert into e6(word,meaning) value('lipstick',               	'n.唇膏,口红');
insert into e6(word,meaning) value('literal',                	'a.文字(上)的;字面的');
insert into e6(word,meaning) value('literally',              	'ad.照字义,逐字地');
insert into e6(word,meaning) value('literary',               	'a.精通文学的');
insert into e6(word,meaning) value('litter',                 	'n.废物,杂乱 vi.乱扔');
insert into e6(word,meaning) value('lobby',                  	'n.前厅,(剧院的)门廊');
insert into e6(word,meaning) value('locality',               	'n.位置,地点,发生地');
insert into e6(word,meaning) value('location',               	'n.定位,测位;测量');
insert into e6(word,meaning) value('locomotive',             	'a.运动的;机动');
insert into e6(word,meaning) value('locust',                 	'n.蝗虫;洋槐,刺槐');
insert into e6(word,meaning) value('lodging',                	'n.寄宿,住宿;住所');
insert into e6(word,meaning) value('lofty',                  	'a.高耸的;高尚的');
insert into e6(word,meaning) value('log',                    	'n.航海日志;飞行日志');
insert into e6(word,meaning) value('longing',                	'n.渴望 a.显示渴望的');
insert into e6(word,meaning) value('longitude',              	'n.经线,经度');
insert into e6(word,meaning) value('loosely',                	'ad.松松地,松散地');
insert into e6(word,meaning) value('loosen',                 	'vi.变松');
insert into e6(word,meaning) value('lounge',                 	'n.(旅馆等的)休息室');
insert into e6(word,meaning) value('lubricate',              	'vt.使润滑vi.加润滑油');
insert into e6(word,meaning) value('luminous',               	'a.发光的;光明的');
insert into e6(word,meaning) value('lump',                   	'vt.(使)成团 vi.结块');
insert into e6(word,meaning) value('lunar',                  	'a.月亮的');
insert into e6(word,meaning) value('luncheon',               	'n.午宴,午餐,便宴');
insert into e6(word,meaning) value('luxurious',              	'a.爱好奢侈的,豪华的');
insert into e6(word,meaning) value('magician',               	'n.魔法师;变戏法的人');
insert into e6(word,meaning) value('magistrate',             	'n.地方行政长官');
insert into e6(word,meaning) value('magnet',                 	'n.有吸引力的人(或物)');
insert into e6(word,meaning) value('magnetism',              	'n.磁;魅力;催眠术');
insert into e6(word,meaning) value('magnify',                	'vt.放大,扩大');
insert into e6(word,meaning) value('magnitude',              	'n.大小;重大;星等');
insert into e6(word,meaning) value('maid',                   	'n.少女;处女');
insert into e6(word,meaning) value('maiden',                 	'n.少女,未婚女子');
insert into e6(word,meaning) value('main',                   	'n.总管道,干线');
insert into e6(word,meaning) value('maintenance',            	'n.扶养;坚持');
insert into e6(word,meaning) value('majesty',                	'n.威严,尊严;陛下');
insert into e6(word,meaning) value('makeup',                 	'n.组织;性格;化装品');
insert into e6(word,meaning) value('malice',                 	'n.恶意;蓄意犯罪');
insert into e6(word,meaning) value('mammal',                 	'n.哺乳动物');
insert into e6(word,meaning) value('manifest',               	'vt.表明 a.明白的');
insert into e6(word,meaning) value('manipulate',             	'vt.操作;控制,手持');
insert into e6(word,meaning) value('mansion',                	'n.大厦,大楼;宅第');
insert into e6(word,meaning) value('manuscript',             	'n.手稿,底稿,原稿');
insert into e6(word,meaning) value('maple',                  	'n.槭树,枫树');
insert into e6(word,meaning) value('margin',                 	'n.余地;幅度;赚头');
insert into e6(word,meaning) value('marginal',               	'a.记在页边的;边缘的');
insert into e6(word,meaning) value('market',                 	'vt.(在市场上)销售');
insert into e6(word,meaning) value('Mars',                   	'n.火星;战争');
insert into e6(word,meaning) value('marsh',                  	'n.沼泽地,湿地');
insert into e6(word,meaning) value('marshal',                	'n.元帅;陆军元帅');
insert into e6(word,meaning) value('martyr',                 	'n.烈士,殉难者');
insert into e6(word,meaning) value('marvel',                 	'n.奇迹;惊奇 vt.惊奇');
insert into e6(word,meaning) value('masculine',              	'a.男性的;强壮的');
insert into e6(word,meaning) value('massacre',               	'n.大屠杀,残杀');
insert into e6(word,meaning) value('massive',                	'a.粗大的;大而重的');
insert into e6(word,meaning) value('mast',                   	'n.桅杆;杆 vt.扯帆');
insert into e6(word,meaning) value('mature',                 	'vt.使成熟 vi.成熟');
insert into e6(word,meaning) value('measurement',            	'n.(量得的)尺寸,大小');
insert into e6(word,meaning) value('mechanics',              	'n.力学,机械学;结构');
insert into e6(word,meaning) value('mechanism',              	'n.机械装置;机制');
insert into e6(word,meaning) value('meditate',               	'vt.沉思,冥想,反省');
insert into e6(word,meaning) value('melancholy',             	'n.&a.忧郁(的),悲伤');
insert into e6(word,meaning) value('melody',                 	'n.旋律,曲调;歌曲');
insert into e6(word,meaning) value('membership',             	'n.成员资格;会员人数');
insert into e6(word,meaning) value('menace',                 	'vt.&vi.&n.(进行)威胁');
insert into e6(word,meaning) value('mend',                   	'vt.改正,修正;改进');
insert into e6(word,meaning) value('merchandise',            	'n.商品,货物');
insert into e6(word,meaning) value('merciful',               	'a.仁慈的,宽大的');
insert into e6(word,meaning) value('mercury',                	'n.汞,水银;水银柱');
insert into e6(word,meaning) value('merit',                  	'vt.值得vi.应受赏(罚)');
insert into e6(word,meaning) value('mesh',                   	'n.网眼,筛孔,网络');
insert into e6(word,meaning) value('mess',                   	'vt.弄脏,弄乱,搞糟');
insert into e6(word,meaning) value('message',                	'n.启示,要旨,教训');
insert into e6(word,meaning) value('metallic',               	'a.金属的 n.金属粒子');
insert into e6(word,meaning) value('metallurgy',             	'n.冶金学,冶金术');
insert into e6(word,meaning) value('metropolitan',           	'a.主要都市的n.大主教');
insert into e6(word,meaning) value('microprocessor',         	'n.微信息处理机');
insert into e6(word,meaning) value('microscopic',            	'a.显微镜的,微观的');
insert into e6(word,meaning) value('microwave',              	'n.微波');
insert into e6(word,meaning) value('mighty',                 	'a.强大的;巨大的');
insert into e6(word,meaning) value('migrate',                	'vi.迁移,移居');
insert into e6(word,meaning) value('mild',                   	'a.(烟、酒)味淡的');
insert into e6(word,meaning) value('milky',                  	'a.牛奶的;乳白色的');
insert into e6(word,meaning) value('millionaire',            	'n.百分富翁,巨富');
insert into e6(word,meaning) value('mingle',                 	'vt.使混合vi.混合起来');
insert into e6(word,meaning) value('miniature',              	'n.缩影 a.缩小的');
insert into e6(word,meaning) value('minimize',               	'vt.使减到最小');
insert into e6(word,meaning) value('mint',                   	'n.薄荷;薄荷糖');
insert into e6(word,meaning) value('mint',                   	'n.造币厂;巨额,富源');
insert into e6(word,meaning) value('mirror',                 	'n.反映,借鉴');
insert into e6(word,meaning) value('mishief',                	'n.调皮,捣蛋,胡闹');
insert into e6(word,meaning) value('miser',                  	'n.守财奴,吝啬鬼');
insert into e6(word,meaning) value('misery',                 	'n.痛苦,悲惨,不幸');
insert into e6(word,meaning) value('misfortune',             	'n.不幸,灾祸,灾难');
insert into e6(word,meaning) value('missionary',             	'n.传教士');
insert into e6(word,meaning) value('mist',                   	'n.薄雾 vi.下薄雾');
insert into e6(word,meaning) value('mistress',               	'n.情妇,情人');
insert into e6(word,meaning) value('mitten',                 	'n.连指手套;露指手套');
insert into e6(word,meaning) value('mixer',                  	'n.混合者,搅拌器');
insert into e6(word,meaning) value('mob',                    	'vi.聚众闹事');
insert into e6(word,meaning) value('mobilize',               	'vt.动员 vi.动员起来');
insert into e6(word,meaning) value('mock',                   	'n.嘲弄 vt.嘲弄,挖苦');
insert into e6(word,meaning) value('moderately',             	'ad.适度地,适中');
insert into e6(word,meaning) value('modesty',                	'n.谦逊;端庄;羞怯');
insert into e6(word,meaning) value('modification',           	'n.缓和;修改;修饰');
insert into e6(word,meaning) value('modulate',               	'vt.调整,调节(声音)');
insert into e6(word,meaning) value('module',                 	'n.模数;模;组件');
insert into e6(word,meaning) value('molecular',              	'a.分子的;克分子的');
insert into e6(word,meaning) value('momentary',              	'a.瞬息间的,片刻的');
insert into e6(word,meaning) value('monarch',                	'n.君主,最高统治者');
insert into e6(word,meaning) value('monk',                   	'n.和尚,僧侣,修道士');
insert into e6(word,meaning) value('monopoly',               	'n.垄断,独占,专利');
insert into e6(word,meaning) value('monster',                	'n.怪物;畸形的动植物');
insert into e6(word,meaning) value('monstrous',              	'a.可怕的;极大的');
insert into e6(word,meaning) value('moor',                   	'vt.使停泊;使固定');
insert into e6(word,meaning) value('mop',                    	'n.墩布,洗碗刷');
insert into e6(word,meaning) value('morality',               	'n.道德,美德,品行');
insert into e6(word,meaning) value('mortgage',               	'n.抵押 vt.抵押');
insert into e6(word,meaning) value('Moslem',                 	'n.&a.穆斯林(的)');
insert into e6(word,meaning) value('mosque',                 	'n.清真寺');
insert into e6(word,meaning) value('moss',                   	'n.苔藓,地衣');
insert into e6(word,meaning) value('motel',                  	'n.汽车游客旅馆');
insert into e6(word,meaning) value('motive',                 	'a.发动的,运动的');
insert into e6(word,meaning) value('motorway',               	'n.汽车道,快车路');
insert into e6(word,meaning) value('mount',                  	'v.装配;固定 n.支架');
insert into e6(word,meaning) value('mountainous',            	'a.多山的;山一般的');
insert into e6(word,meaning) value('move',                   	'n.行动,步骤');
insert into e6(word,meaning) value('multiplication',         	'n.增加;繁殖;乘法');
insert into e6(word,meaning) value('multitude',              	'n.大批,大群;大量');
insert into e6(word,meaning) value('municipal',              	'a.市的,市立的');
insert into e6(word,meaning) value('murmur',                 	'n.低沉连续的声音');
insert into e6(word,meaning) value('muscular',               	'a.肌肉发达的,强健的');
insert into e6(word,meaning) value('muse',                   	'vi.沉思,默想,冥想');
insert into e6(word,meaning) value('mustard',                	'n.芥子,芥末');
insert into e6(word,meaning) value('mute',                   	'n.弱音器;闭止音');
insert into e6(word,meaning) value('mystery',                	'n.神秘小说,侦探小说');
insert into e6(word,meaning) value('napkin',                 	'n.餐巾(纸)');
insert into e6(word,meaning) value('narration',              	'n.叙述;故事;叙述法');
insert into e6(word,meaning) value('negative',               	'a.负的,阴性的');
insert into e6(word,meaning) value('negligible',             	'a.微不足道的');
insert into e6(word,meaning) value('negotiate',              	'vi.谈判,交涉,议定');
insert into e6(word,meaning) value('neighbouring',           	'a.邻近的,接壤的');
insert into e6(word,meaning) value('nest',                   	'vi.筑巢 vt.为…筑巢');
insert into e6(word,meaning) value('net',                    	'vt.用网捕;用网覆盖');
insert into e6(word,meaning) value('network',                	'n.网络;广播网');
insert into e6(word,meaning) value('neutron',                	'n.中子');
insert into e6(word,meaning) value('nice',                   	'a.细微的,微妙的');
insert into e6(word,meaning) value('nickel',                 	'n.镍;镍币');
insert into e6(word,meaning) value('nickname',               	'n.绰号,浑号');
insert into e6(word,meaning) value('nightmare',              	'n.恶梦;经常的恐惧');
insert into e6(word,meaning) value('nominate',               	'vt.提名,推荐;任命');
insert into e6(word,meaning) value('norm',                   	'n.标准,规范;平均数');
insert into e6(word,meaning) value('normalization',          	'n.正常化,标准化');
insert into e6(word,meaning) value('northward(s)','ad.向北方 a.向北的');
insert into e6(word,meaning) value('nose',                   	'n.突出部分(如船头等)');
insert into e6(word,meaning) value('notable',                	'n.值得注意的;著名的');
insert into e6(word,meaning) value('noted',                  	'a.著名的,知名的');
insert into e6(word,meaning) value('notify',                 	'vt.通知,告知;报告');
insert into e6(word,meaning) value('notion',                 	'n.概念,意念;看法');
insert into e6(word,meaning) value('notorious',              	'a.臭名昭著的');
insert into e6(word,meaning) value('notwithstanding',        	'prep.尽管,虽然');
insert into e6(word,meaning) value('nought',                 	'n.无,零');
insert into e6(word,meaning) value('nourish',                	'vt.提供养分,养育');
insert into e6(word,meaning) value('nourishment',            	'n.食物;营养(情况)');
insert into e6(word,meaning) value('novel',                  	'a.新的,异常的');
insert into e6(word,meaning) value('novelty',                	'n.新颖;新奇的事物');
insert into e6(word,meaning) value('nucleus',                	'n.原子核;细胞核');
insert into e6(word,meaning) value('number',                 	'vt.共计,达…之数');
insert into e6(word,meaning) value('numerical',              	'a.数字的,数值的');
insert into e6(word,meaning) value('nun',                    	'n.修女,尼姑');
insert into e6(word,meaning) value('nursery',                	'n.苗圃,养鱼池');
insert into e6(word,meaning) value('nut',                    	'n.螺帽,螺母');
insert into e6(word,meaning) value('oar',                    	'n.桨;划手 vi.划(行)');
insert into e6(word,meaning) value('oath',                   	'n.誓言,誓约,宣誓');
insert into e6(word,meaning) value('obedience',              	'n.服从,顺从;管辖');
insert into e6(word,meaning) value('obedient',               	'n.服从的,顺从的');
insert into e6(word,meaning) value('objective',              	'n.宾格 a.目标的');
insert into e6(word,meaning) value('obligation',             	'n.义务,职责,责任');
insert into e6(word,meaning) value('oblige',                 	'vt.使感激;施恩惠于');
insert into e6(word,meaning) value('obscure',                	'a.阴暗的;蒙昧的');
insert into e6(word,meaning) value('observation',            	'n.意见,短评,按语');
insert into e6(word,meaning) value('observe',                	'vi.说,评述,评论');
insert into e6(word,meaning) value('obstinate',              	'a.固执的;顽强的');
insert into e6(word,meaning) value('occurrence',             	'n.事故');
insert into e6(word,meaning) value('offence',                	'n.犯罪,犯规;冒犯');
insert into e6(word,meaning) value('offensive',              	'a.冒犯的;进攻的');
insert into e6(word,meaning) value('offer',                  	'vt.呈现出 vi.出现');
insert into e6(word,meaning) value('offset',                 	'n.分支,抵销 vt.抵销');
insert into e6(word,meaning) value('offspring',              	'n.儿女,子孙,后代');
insert into e6(word,meaning) value('ohm',                    	'n.欧姆');
insert into e6(word,meaning) value('olive',                  	'n.橄榄,橄榄树');
insert into e6(word,meaning) value('onward(s)','a.向前(的),在前面');
insert into e6(word,meaning) value('opaque',                 	'a.不透明的;不传导的');
insert into e6(word,meaning) value('operation',              	'n.运算');
insert into e6(word,meaning) value('opium',                  	'n.鸦片;麻醉剂');
insert into e6(word,meaning) value('optical',                	'a.光的;光学的');
insert into e6(word,meaning) value('optimism',               	'n.乐观,乐观主义');
insert into e6(word,meaning) value('optimum',                	'n.最适条件,最适度');
insert into e6(word,meaning) value('option',                 	'n.选择,取舍');
insert into e6(word,meaning) value('orchard',                	'n.果园');
insert into e6(word,meaning) value('orchestra',              	'n.管弦乐队的全部乐器');
insert into e6(word,meaning) value('ordinarily',             	'ad.通常,大概');
insert into e6(word,meaning) value('orient',                 	'n.东方;亚洲,远东');
insert into e6(word,meaning) value('orientation',            	'n.向东;定位;方向');
insert into e6(word,meaning) value('originate',              	'vi.发源 vt.首创');
insert into e6(word,meaning) value('ornament',               	'n.装饰物 vt.装修');
insert into e6(word,meaning) value('ornamental',             	'a.装饰的 n.装饰品');
insert into e6(word,meaning) value('otherwise',              	'ad.另外;在其他方面');
insert into e6(word,meaning) value('ought',                  	'v.aux 早应该,本应');
insert into e6(word,meaning) value('outbreak',               	'n.(战争、愤怒等)爆发');
insert into e6(word,meaning) value('outcome',                	'n.后果,成果');
insert into e6(word,meaning) value('outermost',              	'a.最外面的,最远的');
insert into e6(word,meaning) value('outlaw',                 	'n.逃犯,歹徒');
insert into e6(word,meaning) value('outlet',                 	'n.发泄(感情等)的方法');
insert into e6(word,meaning) value('outline',                	'vt.概述,概括');
insert into e6(word,meaning) value('outside',                	'prep.在…外,向…外');
insert into e6(word,meaning) value('oval',                   	'a.卵形的 n.卵形');
insert into e6(word,meaning) value('over',                   	'prep.在(做)…时');
insert into e6(word,meaning) value('overall',                	'a.综合的 n.工作服');
insert into e6(word,meaning) value('overestimate',           	'vt.过高估计');
insert into e6(word,meaning) value('overflow',               	'vt.从…中溢出');
insert into e6(word,meaning) value('overhang',               	'vt.悬于…之上vi.悬垂');
insert into e6(word,meaning) value('overhear',               	'vt.偶然听到;偷听');
insert into e6(word,meaning) value('overlap',                	'vt.与…交搭 vi.重迭');
insert into e6(word,meaning) value('overload',               	'vt.使超载');
insert into e6(word,meaning) value('overlook',               	'vt.眺望;看漏;宽容');
insert into e6(word,meaning) value('overseas',               	'ad.在海外,(向)国外');
insert into e6(word,meaning) value('overtake',               	'vt.突然袭击,压倒');
insert into e6(word,meaning) value('overthrow',              	'vt.推翻 n.推翻,瓦解');
insert into e6(word,meaning) value('overwhelm',              	'vt.压倒,使不知所措');
insert into e6(word,meaning) value('overwhelming',           	'a.压倒的,势不可挡的');
insert into e6(word,meaning) value('oxide',                  	'n.氧化物');
insert into e6(word,meaning) value('oxidize',                	'vt.氧化,使生锈');
insert into e6(word,meaning) value('oyster',                 	'n.牡蛎;沉默寡言的人');
insert into e6(word,meaning) value('pace',                   	'vi.(马)溜蹄走');
insert into e6(word,meaning) value('pacific',                	'a.性情温和的');
insert into e6(word,meaning) value('pal',                    	'n.好朋友;同谋');
insert into e6(word,meaning) value('pamphlet',               	'n.小册子');
insert into e6(word,meaning) value('panel',                  	'n.(选定的)专门小组');
insert into e6(word,meaning) value('panic',                  	'n.恐慌,惊慌');
insert into e6(word,meaning) value('pant',                   	'vi.气喘');
insert into e6(word,meaning) value('panther',                	'n.豹,黑豹;美洲狮');
insert into e6(word,meaning) value('pantry',                 	'n.食品柜,餐具室');
insert into e6(word,meaning) value('pants',                  	'n.裤子;男用短衬裤');
insert into e6(word,meaning) value('paper',                  	'vt.用纸包装(或覆盖)');
insert into e6(word,meaning) value('parachute',              	'n.降落伞;风散种子');
insert into e6(word,meaning) value('parade',                 	'vt.夸耀(才能等)');
insert into e6(word,meaning) value('paragraph',              	'n.小新闻,短评');
insert into e6(word,meaning) value('paralyse',               	'vt.使麻痹,使瘫痪');
insert into e6(word,meaning) value('parameter',              	'n.参(变)数;参量');
insert into e6(word,meaning) value('participant',            	'n.参加者 a.有份的');
insert into e6(word,meaning) value('participate',            	'vi.参与 vt.分享');
insert into e6(word,meaning) value('particular',             	'a.苛求的;特称的');
insert into e6(word,meaning) value('partition',              	'n.分开,分割;融墙');
insert into e6(word,meaning) value('passport',               	'n.达到目的的手段');
insert into e6(word,meaning) value('pasture',                	'n.牧场;牲畜饲养');
insert into e6(word,meaning) value('patent',                 	'a.专利的 n.专利');
insert into e6(word,meaning) value('pathetic',               	'a.哀婉动人的;可怜的');
insert into e6(word,meaning) value('patriot',                	'n.爱国者,爱国主义者');
insert into e6(word,meaning) value('patriotic',              	'a.爱国的');
insert into e6(word,meaning) value('patrol',                 	'n.巡逻 n.巡逻,巡查');
insert into e6(word,meaning) value('patron',                 	'n.庇护人;赞助人');
insert into e6(word,meaning) value('pattern',                	'vt.仿制,仿造,模仿');
insert into e6(word,meaning) value('peacock',                	'n.孔雀');
insert into e6(word,meaning) value('peak',                   	'n.(物体的)尖端');
insert into e6(word,meaning) value('peck',                   	'vt.&vi.啄,啄起');
insert into e6(word,meaning) value('peculiarity',            	'n.特性,独特性;怪癖');
insert into e6(word,meaning) value('pedal',                  	'n.踏脚,踏板,脚蹬');
insert into e6(word,meaning) value('pedestrian',             	'n.行人,步行者');
insert into e6(word,meaning) value('pedlar',                 	'n.(挨户兜售的)小贩');
insert into e6(word,meaning) value('peel',                   	'n.果皮,蔬菜皮');
insert into e6(word,meaning) value('peer',                   	'vi.凝视;隐约出现');
insert into e6(word,meaning) value('penalty',                	'n.处罚,刑罚;罚款');
insert into e6(word,meaning) value('penetration',            	'n.穿入;渗透,侵入');
insert into e6(word,meaning) value('pendulum',               	'n.(钟等的)摆');
insert into e6(word,meaning) value('perception',             	'n.感觉;概念;理解力');
insert into e6(word,meaning) value('perch',                  	'n.(禽鸟的)栖木');
insert into e6(word,meaning) value('perfect',                	'vt.使熟练,使改善');
insert into e6(word,meaning) value('perfection',             	'n.尽善尽美;无比精确');
insert into e6(word,meaning) value('peril',                  	'n.危机;危险的事物');
insert into e6(word,meaning) value('perimeter',              	'n.周(边),周长');
insert into e6(word,meaning) value('periodic',               	'n.周期的;一定时期的');
insert into e6(word,meaning) value('periodical',             	'n.期刊,杂志');
insert into e6(word,meaning) value('peripheral',             	'a.周界的;末梢的');
insert into e6(word,meaning) value('perish',                 	'vi.死亡,夭折;枯萎');
insert into e6(word,meaning) value('perpendicular',          	'a.垂直的 n.垂直(线)');
insert into e6(word,meaning) value('perpetual',              	'a.永久的;四季开花的');
insert into e6(word,meaning) value('perplex',                	'vt.迷惑,困惑,难住');
insert into e6(word,meaning) value('persecute',              	'vt.迫害,残害');
insert into e6(word,meaning) value('persevere',              	'vi.坚持,不屈不挠');
insert into e6(word,meaning) value('persist',                	'vi.持续,存留');
insert into e6(word,meaning) value('persistence',            	'n.坚持;持续,存留');
insert into e6(word,meaning) value('personality',            	'n.人格,个性;人物');
insert into e6(word,meaning) value('personnel',              	'n.人事部门');
insert into e6(word,meaning) value('persuasion',             	'n.劝说,说服;主张');
insert into e6(word,meaning) value('pertinent',              	'a.恰当的;有关的');
insert into e6(word,meaning) value('pest',                   	'n.害虫;害人虫');
insert into e6(word,meaning) value('petition',               	'n.请愿 vt.向…请愿');
insert into e6(word,meaning) value('petty',                  	'a.细小的;器量小的');
insert into e6(word,meaning) value('photoelectric',          	'a.光电的');
insert into e6(word,meaning) value('photography',            	'n.摄影术');
insert into e6(word,meaning) value('physically',             	'ad.物质上;体格上');
insert into e6(word,meaning) value('pickle',                 	'n.腌制食品,泡菜');
insert into e6(word,meaning) value('pier',                   	'n.(桥)墩;码头');
insert into e6(word,meaning) value('pierce',                 	'vt.穿透,戳穿,洞察');
insert into e6(word,meaning) value('pilgrim',                	'n.香客,朝圣者');
insert into e6(word,meaning) value('pineapple',              	'n.凤梨,波萝');
insert into e6(word,meaning) value('pious',                  	'a.虔诚的;虔奉宗教的');
insert into e6(word,meaning) value('pipe',                   	'n.管乐器');
insert into e6(word,meaning) value('pirate',                 	'n.海盗;每盗船');
insert into e6(word,meaning) value('piston',                 	'n.活塞');
insert into e6(word,meaning) value('pitch',                  	'n.人造树脂');
insert into e6(word,meaning) value('plague',                 	'n.瘟疫,鼠疫;天灾');
insert into e6(word,meaning) value('plain',                  	'a.坦白的;普通的');
insert into e6(word,meaning) value('plastic',                	'a.塑料的;塑性的');
insert into e6(word,meaning) value('plateau',                	'n.高原;平稳时期');
insert into e6(word,meaning) value('platform',               	'n.政纲,党纲,宣言');
insert into e6(word,meaning) value('plea',                   	'n.请愿,请求,恳求');
insert into e6(word,meaning) value('plead',                  	'vt.为…辩护 vi.抗辩');
insert into e6(word,meaning) value('pledge',                 	'n.誓言 vt.使发誓');
insert into e6(word,meaning) value('pluck',                  	'vt.鼓起(勇气),振作');
insert into e6(word,meaning) value('plump',                  	'vt.丰满的;鼓起的');
insert into e6(word,meaning) value('plunder',                	'v.&n.掠夺,劫掠');
insert into e6(word,meaning) value('pneumatic',              	'a.空气的;气动的');
insert into e6(word,meaning) value('poke',                   	'vt.戳,刺;伸(头等)');
insert into e6(word,meaning) value('polar',                  	'a.南(北)极的;极性的');
insert into e6(word,meaning) value('polarity',               	'n.极性;(思想等)归向');
insert into e6(word,meaning) value('politics',               	'n.政纲,政见,策略');
insert into e6(word,meaning) value('poll',                   	'n.投票 vi.投票');
insert into e6(word,meaning) value('polymer',                	'n.聚合物,多聚物');
insert into e6(word,meaning) value('ponder',                 	'vt.考虑 vi.沉思');
insert into e6(word,meaning) value('pop',                    	'vi.(意外地)出现');
insert into e6(word,meaning) value('pope',                   	'n.(罗马天主教的)教皇');
insert into e6(word,meaning) value('popularity',             	'n.通俗性;普及,流行');
insert into e6(word,meaning) value('porcelain',              	'n.瓷 a.瓷的,瓷制的');
insert into e6(word,meaning) value('pore',                   	'n.毛孔,气孔,细孔');
insert into e6(word,meaning) value('portable',               	'a.可移动的');
insert into e6(word,meaning) value('pose',                   	'vt.(使)摆好姿势');
insert into e6(word,meaning) value('position',               	'n.主张,立场;形势');
insert into e6(word,meaning) value('positive',               	'a.正的;阳性的');
insert into e6(word,meaning) value('positively',             	'ad.确定的,断然');
insert into e6(word,meaning) value('possibility',            	'n.可能的事');
insert into e6(word,meaning) value('postal',                 	'a.邮政的,邮局的');
insert into e6(word,meaning) value('postulate',              	'vt.要求,假定,假设');
insert into e6(word,meaning) value('poultry',                	'n.家禽');
insert into e6(word,meaning) value('practicable',            	'a.能实行的;适用的');
insert into e6(word,meaning) value('prairie',                	'n.大草原,牧场');
insert into e6(word,meaning) value('preach',                 	'vt.说教,布道;鼓吹');
insert into e6(word,meaning) value('precede',                	'vt.先于… vi.领先');
insert into e6(word,meaning) value('predecessor',            	'n.前辈,前任者');
insert into e6(word,meaning) value('prediction',             	'n.预言,预告;预报');
insert into e6(word,meaning) value('predominant',            	'a.占优势的;主要的');
insert into e6(word,meaning) value('pregnant',               	'a.怀孕的;意义深长的');
insert into e6(word,meaning) value('prejudice',              	'n.偏见,成见;损害');
insert into e6(word,meaning) value('prescription',           	'n.药方,处方的药');
insert into e6(word,meaning) value('presentation',           	'n.介绍;赠送;呈现');
insert into e6(word,meaning) value('preservation',           	'n.保存,储藏;保持');
insert into e6(word,meaning) value('preset',                 	'vt.预先装置');
insert into e6(word,meaning) value('preside',                	'vi.主持;主奏');
insert into e6(word,meaning) value('press',                  	'n.印刷机,印刷所');
insert into e6(word,meaning) value('pressure',               	'n.电压;大气压力');
insert into e6(word,meaning) value('prestige',               	'n.威望,威信,声望');
insert into e6(word,meaning) value('presumably',             	'ad.推测起来,大概');
insert into e6(word,meaning) value('presume',                	'vt.假定,假设,揣测');
insert into e6(word,meaning) value('prevalent',              	'a.流行的;盛行的');
insert into e6(word,meaning) value('prevention',             	'n.预防,阻止,妨碍');
insert into e6(word,meaning) value('prey',                   	'vi.猎物 vi.捕获');
insert into e6(word,meaning) value('prick',                  	'vt.刺(穿) n.刺孔');
insert into e6(word,meaning) value('primitive',              	'a.远古的,未开化的');
insert into e6(word,meaning) value('principally',            	'ad.主要,大抵');
insert into e6(word,meaning) value('printer',                	'n.印刷工;印花工');
insert into e6(word,meaning) value('priority',               	'n.先,前;优先,重点');
insert into e6(word,meaning) value('prism',                  	'n.棱柱(体);棱镜');
insert into e6(word,meaning) value('probe',                  	'n.探针 vt.用探针探查');
insert into e6(word,meaning) value('proceeding',             	'n.程序,行动,事项');
insert into e6(word,meaning) value('producer',               	'n.生产者;舞台监督');
insert into e6(word,meaning) value('productive',             	'a.生产的;出产…的');
insert into e6(word,meaning) value('productivity',           	'n.生产率;多产');
insert into e6(word,meaning) value('proficiency',            	'n.熟练,精通');
insert into e6(word,meaning) value('proficient',             	'a.熟练的,精通的');
insert into e6(word,meaning) value('profitable',             	'a.有利的;有益的');
insert into e6(word,meaning) value('profound',               	'a.深刻的;渊博的');
insert into e6(word,meaning) value('program',                	'vi.编制程序');
insert into e6(word,meaning) value('prohibition',            	'n.禁止;禁令,禁律');
insert into e6(word,meaning) value('projector',              	'n.投影仪;探照灯');
insert into e6(word,meaning) value('prolong',                	'vt.延长,拉长,拖延');
insert into e6(word,meaning) value('promotion',              	'n.促进;提升;创立');
insert into e6(word,meaning) value('promptly',               	'ad.敏捷地,迅速地');
insert into e6(word,meaning) value('propaganda',             	'n.宣传;宣传机构');
insert into e6(word,meaning) value('propagate',              	'vt.繁殖;传播,普及');
insert into e6(word,meaning) value('propagation',            	'n.繁殖;传播;蔓延');
insert into e6(word,meaning) value('propel',                 	'vt.推进,推动');
insert into e6(word,meaning) value('propeller',              	'n.螺旋桨,推进器');
insert into e6(word,meaning) value('proper',                 	'a.合乎体统的,正派的');
insert into e6(word,meaning) value('prophecy',               	'n.预言,预言能力');
insert into e6(word,meaning) value('prophet',                	'n.预言家,先知');
insert into e6(word,meaning) value('proposition',            	'n.命题,主题;提议');
insert into e6(word,meaning) value('propulsion',             	'n.推进,推进力');
insert into e6(word,meaning) value('prose',                  	'n.散文');
insert into e6(word,meaning) value('proton',                 	'n.质子,氕核');
insert into e6(word,meaning) value('prototype',              	'n.原型;典型,范例');
insert into e6(word,meaning) value('proverb',                	'n.谚语,格言,箴言');
insert into e6(word,meaning) value('province',               	'n.领域,范围,职权');
insert into e6(word,meaning) value('provision',              	'n.规定,条款,条项');
insert into e6(word,meaning) value('provoke',                	'vt.对…挑衅;激发');
insert into e6(word,meaning) value('prudent',                	'a.谨慎的;精明的');
insert into e6(word,meaning) value('psychology',             	'n.心理学;心理');
insert into e6(word,meaning) value('puff',                   	'vi.喘气 vt.喷(烟等)');
insert into e6(word,meaning) value('pulley',                 	'n.滑轮,滑车,皮带轮');
insert into e6(word,meaning) value('pumpkin',                	'n.南瓜,南瓜藤');
insert into e6(word,meaning) value('punch',                  	'vt.冲压 n.冲压机');
insert into e6(word,meaning) value('puppy',                  	'n.小狗;幼小的动物');
insert into e6(word,meaning) value('purify',                 	'vt.提纯,精炼(金属)');
insert into e6(word,meaning) value('pyjamas',                	'n.(宽大的)睡衣裤');
insert into e6(word,meaning) value('qualification',          	'n.资格;限制条件');
insert into e6(word,meaning) value('qualify',                	'vt.限制,限定,修饰');
insert into e6(word,meaning) value('qualitative',            	'a.质的;定性的');
insert into e6(word,meaning) value('quantify',               	'vt.确定…的数量');
insert into e6(word,meaning) value('quantitative',           	'a.量的;定量的');
insert into e6(word,meaning) value('quarterly',              	'a.季度的 ad.季度地');
insert into e6(word,meaning) value('quartz',                 	'n.石英');
insert into e6(word,meaning) value('quench',                 	'vt.熄灭,扑灭;压制');
insert into e6(word,meaning) value('quest',                  	'vt.寻找 vi.追求');
insert into e6(word,meaning) value('question',               	'vt.问,询问,讯问');
insert into e6(word,meaning) value('questionable',           	'a.可疑的,不可靠的');
insert into e6(word,meaning) value('questionnaire',          	'n.调查表,征求意见表');
insert into e6(word,meaning) value('quiver',                 	'vi.(轻微地)颤动');
insert into e6(word,meaning) value('radial',                 	'a.光线的;放射的');
insert into e6(word,meaning) value('radiant',                	'a.绚丽的;容光焕发的');
insert into e6(word,meaning) value('radiator',               	'n.暖气片,散热器');
insert into e6(word,meaning) value('radical',                	'a.基本的;激进的');
insert into e6(word,meaning) value('radius',                 	'n.半径距离;界限');
insert into e6(word,meaning) value('raise',                  	'vt.提出,发起,发出');
insert into e6(word,meaning) value('raisin',                 	'n.葡萄干');
insert into e6(word,meaning) value('rally',                  	'n.&vt.&vi.(重新)集合');
insert into e6(word,meaning) value('ramble',                 	'vi.闲逛,漫步;聊天');
insert into e6(word,meaning) value('ranch',                  	'n.(北美洲的)大牧场');
insert into e6(word,meaning) value('random',                 	'n.随机 a.随机的');
insert into e6(word,meaning) value('range',                  	'vt.排列;把…分类');
insert into e6(word,meaning) value('rap',                    	'n.轻敲击声 vt.敲击');
insert into e6(word,meaning) value('rapidity',               	'n.快,迅速;陡,险峻');
insert into e6(word,meaning) value('rapture',                	'n.狂喜,欢天喜地');
insert into e6(word,meaning) value('rascal',                 	'n.流氓,恶棍,无赖');
insert into e6(word,meaning) value('rash',                   	'a.轻率的;鲁莽的');
insert into e6(word,meaning) value('rate',                   	'n.价格 vt.对…评定');
insert into e6(word,meaning) value('rational',               	'a.推理的;适度的');
insert into e6(word,meaning) value('rattle',                 	'vt.发出格格声');
insert into e6(word,meaning) value('reactor',                	'n.反应器;反应堆');
insert into e6(word,meaning) value('realistic',              	'a.现实的;现实主义的');
insert into e6(word,meaning) value('realization',            	'n.(理想等的)实现');
insert into e6(word,meaning) value('rear',                   	'vt.饲养,培植;抚养');
insert into e6(word,meaning) value('reason',                 	'vt.辩论,讨论');
insert into e6(word,meaning) value('rebuke',                 	'vt.指责,非难,斥责');
insert into e6(word,meaning) value('receiver',               	'n.接待者;收受者');
insert into e6(word,meaning) value('recipe',                 	'n.菜谱,烹饪法;处方');
insert into e6(word,meaning) value('reciprocal',             	'a.相互的;互利的');
insert into e6(word,meaning) value('reckless',               	'a.粗心大意的;鲁莽的');
insert into e6(word,meaning) value('reckon',                 	'vi.数,算帐 vt.认为');
insert into e6(word,meaning) value('reclaim',                	'vt.开垦,开拓;回收');
insert into e6(word,meaning) value('recognition',            	'n.认出,识别;重视');
insert into e6(word,meaning) value('recommendation',         	'n.推荐,介绍;建议');
insert into e6(word,meaning) value('reconcile',              	'vt.使和好;调停');
insert into e6(word,meaning) value('recreation',             	'n.消遣,娱乐活动');
insert into e6(word,meaning) value('rectangle',              	'n.矩形,长方形');
insert into e6(word,meaning) value('rectify',                	'vt.纠正;调整;精馏');
insert into e6(word,meaning) value('reed',                   	'n.芦笛,牧笛');
insert into e6(word,meaning) value('reef',                   	'n.礁,礁石,暗礁');
insert into e6(word,meaning) value('reel',                   	'vt.卷,绕');
insert into e6(word,meaning) value('referee',                	'n.(足球等)裁判员');
insert into e6(word,meaning) value('reference',              	'n.参考文献;参照系');
insert into e6(word,meaning) value('refinery',               	'n.精炼厂,提炼厂');
insert into e6(word,meaning) value('refrain',                	'vi.抑制,制止,忍住');
insert into e6(word,meaning) value('refreshment',            	'n.(精力的)恢复,爽快');
insert into e6(word,meaning) value('refugee',                	'n.难民,流亡者');
insert into e6(word,meaning) value('regenerative',           	'a.新生的;回授的');
insert into e6(word,meaning) value('regime',                 	'n.政体,政权;制度');
insert into e6(word,meaning) value('regiment',               	'n.团,军团;一大群');
insert into e6(word,meaning) value('regularity',             	'n.规则性;整齐');
insert into e6(word,meaning) value('regulate',               	'vt.调整,调节,对准');
insert into e6(word,meaning) value('regulation',             	'n.规章,规则;调节');
insert into e6(word,meaning) value('reign',                  	'n.朝代');
insert into e6(word,meaning) value('reject',                 	'vt.舍弃,抛弃;排斥');
insert into e6(word,meaning) value('relay',                  	'vt.分程传递;使接替');
insert into e6(word,meaning) value('religion',               	'n.信念,信条');
insert into e6(word,meaning) value('remainder',              	'n.剩余(物);余数');
insert into e6(word,meaning) value('repay',                  	'vt.&vi.偿还,报答');
insert into e6(word,meaning) value('repeal',                 	'vt.撤销;放弃 n.撤销');
insert into e6(word,meaning) value('repel',                  	'vt.拒绝;使厌恶');
insert into e6(word,meaning) value('replace',                	'vt.送还,归还,赔还');
insert into e6(word,meaning) value('replacement',            	'n.归还;取代;置换');
insert into e6(word,meaning) value('report',                 	'n.传说,议论');
insert into e6(word,meaning) value('representation',         	'n.描写;陈述;代表');
insert into e6(word,meaning) value('representative',         	'a.代表性的;代议制的');
insert into e6(word,meaning) value('reproduce',              	'vt.仿造');
insert into e6(word,meaning) value('reproduction',           	'n.再生(产);繁殖');
insert into e6(word,meaning) value('reptile',                	'n.爬行动物;两栖动物');
insert into e6(word,meaning) value('requisite',              	'a.需要的 n.必需品');
insert into e6(word,meaning) value('resemblance',            	'n.相似,相似性');
insert into e6(word,meaning) value('resent',                 	'vt.对…不满,怨恨');
insert into e6(word,meaning) value('reservation',            	'n.保留;预定,预订');
insert into e6(word,meaning) value('reserve',                	'n.缄默,自我克制');
insert into e6(word,meaning) value('reside',                 	'vi.居住,驻扎;属于');
insert into e6(word,meaning) value('resident',               	'n.常住者');
insert into e6(word,meaning) value('residual',               	'a.剩余的;残数的');
insert into e6(word,meaning) value('resign',                 	'vt.使顺从,使听任于');
insert into e6(word,meaning) value('resignation',            	'n.听从,屈从,顺从');
insert into e6(word,meaning) value('resolute',               	'a.坚决的,果敢的');
insert into e6(word,meaning) value('respectable',            	'a.可敬的;人格高尚的');
insert into e6(word,meaning) value('response',               	'n.回音,回签;灵敏度');
insert into e6(word,meaning) value('responsible',            	'a.重要的;可靠的');
insert into e6(word,meaning) value('restrain',               	'vt.抑制,制止,遏制');
insert into e6(word,meaning) value('resultant',              	'a.作为结果而发生的');
insert into e6(word,meaning) value('resume',                 	'n.(谋职者的)个人简历');
insert into e6(word,meaning) value('retail',                 	'n.零售 a.零售的');
insert into e6(word,meaning) value('retard',                 	'vt.延迟,放慢');
insert into e6(word,meaning) value('retirement',             	'n.退休,引退;退隐');
insert into e6(word,meaning) value('retort',                 	'vt.&vi.反击;反驳');
insert into e6(word,meaning) value('reveal',                 	'vt.告诉,揭示,泄露');
insert into e6(word,meaning) value('revenue',                	'n.收入;收入数目');
insert into e6(word,meaning) value('reverse',                	'n.背面,反面');
insert into e6(word,meaning) value('revive',                 	'vt.&vi.苏醒;复兴');
insert into e6(word,meaning) value('revolve',                	'vt.&vi.(使)旋转');
insert into e6(word,meaning) value('ridicule',               	'vi.&n.嘲弄,挖苦');
insert into e6(word,meaning) value('rigorous',               	'a.(性格等)严峻的');
insert into e6(word,meaning) value('rim',                    	'n.边;边缘,(眼镜)框');
insert into e6(word,meaning) value('rinse',                  	'vt.涮,嗽;冲洗');
insert into e6(word,meaning) value('riot',                   	'n.&vi.骚乱,暴乱');
insert into e6(word,meaning) value('rip',                    	'vi.撕啐,扯破,划破');
insert into e6(word,meaning) value('ripple',                 	'n.涟漪,细浪,波纹');
insert into e6(word,meaning) value('roam',                   	'vt.在…漫步,漫游');
insert into e6(word,meaning) value('roller',                 	'n.滚柱,滚筒,辊');
insert into e6(word,meaning) value('Roman',                  	'n.罗马人,古罗马人');
insert into e6(word,meaning) value('romance',                	'n.传奇;浪漫文学');
insert into e6(word,meaning) value('romantic',               	'a.好幻想的');
insert into e6(word,meaning) value('rooster',                	'n.公鸡;狂妄自负的人');
insert into e6(word,meaning) value('rotate',                 	'vt.&vi.(使)旋转');
insert into e6(word,meaning) value('roundabout',             	'a.迂回的;转弯抹角的');
insert into e6(word,meaning) value('routine',                	'a.日常的 n.常规');
insert into e6(word,meaning) value('row',                    	'n.吵嚷,吵架,口角');
insert into e6(word,meaning) value('royalty',                	'n.皇家,王族,皇族');
insert into e6(word,meaning) value('ruby',                   	'n.红宝石');
insert into e6(word,meaning) value('rule',                   	'n.裁决,裁定');
insert into e6(word,meaning) value('ruthless',               	'a.无情的,冷酷的');
insert into e6(word,meaning) value('safeguard',              	'n.保护措施;护照');
insert into e6(word,meaning) value('salmon',                 	'n.鲑,大马哈鱼');
insert into e6(word,meaning) value('salute',                 	'vt.迎接,欢迎');
insert into e6(word,meaning) value('sandwich',               	'vt.夹入,挤进');
insert into e6(word,meaning) value('sardine',                	'n.沙丁鱼');
insert into e6(word,meaning) value('satellite',              	'n.附属物');
insert into e6(word,meaning) value('satisfaction',           	'n.快事,乐事;愉快');
insert into e6(word,meaning) value('satisfactorily',         	'ad.圆满地');
insert into e6(word,meaning) value('saturation',             	'n.饱和(状态);浸透');
insert into e6(word,meaning) value('Saturn',                 	'n.农神;土星');
insert into e6(word,meaning) value('scan',                   	'n.扫描,扫掠');
insert into e6(word,meaning) value('scandal',                	'n.丑事,丑闻;耻辱');
insert into e6(word,meaning) value('scar',                   	'n.瘢痕');
insert into e6(word,meaning) value('scarcity',               	'n.缺乏,不足,萧条');
insert into e6(word,meaning) value('scarlet',                	'n.猩红色 a.猩红的');
insert into e6(word,meaning) value('scheme',                 	'vt.计划 vi.搞阴谋');
insert into e6(word,meaning) value('scholarship',            	'n.学问,学识;奖学金');
insert into e6(word,meaning) value('scoff',                  	'vt.&vi.嘲笑,嘲弄');
insert into e6(word,meaning) value('scope',                  	'n.眼界');
insert into e6(word,meaning) value('scorch',                 	'vi.烧焦,枯萎;挖苦');
insert into e6(word,meaning) value('scout',                  	'vt.搜索,侦察,跟踪');
insert into e6(word,meaning) value('scramble',               	'vi.&n.爬行,攀登');
insert into e6(word,meaning) value('scrap',                  	'n.碎片;废料 vt.废弃');
insert into e6(word,meaning) value('scratch',                	'n.起跑线,起步线');
insert into e6(word,meaning) value('scripture',              	'n.《圣经》;圣书');
insert into e6(word,meaning) value('scrub',                  	'n.&vt.擦洗,擦净');
insert into e6(word,meaning) value('sculpture',              	'n.雕刻(术);雕刻品');
insert into e6(word,meaning) value('seam',                   	'n.缝口;接缝;骨缝');
insert into e6(word,meaning) value('seaport',                	'n.海港,港口,港市');
insert into e6(word,meaning) value('seaside',                	'n.海滨(胜地);海边');
insert into e6(word,meaning) value('second',                 	'vt.支持');
insert into e6(word,meaning) value('second-hand',            	'n.旧的,第二手的');
insert into e6(word,meaning) value('section',                	'n.切下的部分');
insert into e6(word,meaning) value('seemingly',              	'ad.表面上,外表上');
insert into e6(word,meaning) value('segment',                	'n.切片,部分;段,节');
insert into e6(word,meaning) value('selection',              	'n.精选的东西;选择');
insert into e6(word,meaning) value('senator',                	'n.参议员;评议员');
insert into e6(word,meaning) value('sensation',              	'n.感觉,知觉;轰动');
insert into e6(word,meaning) value('senseless',              	'a.愚蠢的,无意义的');
insert into e6(word,meaning) value('sensible',               	'a.明显的,感觉得到的');
insert into e6(word,meaning) value('sensitivity',            	'n.敏感(性);灵敏性');
insert into e6(word,meaning) value('sensor',                 	'n.传感器,灵敏元件');
insert into e6(word,meaning) value('sentiment',              	'n.感情;情操;情绪');
insert into e6(word,meaning) value('sequence',               	'n.序列');
insert into e6(word,meaning) value('sermon',                 	'n.布道,讲道,说教');
insert into e6(word,meaning) value('serpent',                	'n.蛇(尤指大蛇或毒蛇)');
insert into e6(word,meaning) value('set',                    	'n.集(合)');
insert into e6(word,meaning) value('settlement',             	'n.调停;(新)住宅区');
insert into e6(word,meaning) value('severe',                 	'a.激烈的;简朴的');
insert into e6(word,meaning) value('shabby',                 	'a.褴褛的;破旧的');
insert into e6(word,meaning) value('shade',                  	'n.(色彩的)浓淡,深浅');
insert into e6(word,meaning) value('shadowy',                	'a.有影的;幽暗的');
insert into e6(word,meaning) value('shady',                  	'a.可疑的,靠不住的');
insert into e6(word,meaning) value('shaft',                  	'n.(工具的)柄,杆状物');
insert into e6(word,meaning) value('sham',                   	'n.假冒;膺品 vt.假装');
insert into e6(word,meaning) value('shame',                  	'vt.使羞愧,玷辱');
insert into e6(word,meaning) value('shameful',               	'a.可耻的;不道德的');
insert into e6(word,meaning) value('shark',                  	'n.鲨鱼;贪婪狡猾的人');
insert into e6(word,meaning) value('sharply',                	'ad.严厉地,苛刻地');
insert into e6(word,meaning) value('shatter',                	'vt.粉碎,破碎;毁坏');
insert into e6(word,meaning) value('sheer',                  	'a.纯粹的;全然的');
insert into e6(word,meaning) value('shell',                  	'n.炮弹,猎枪子弹');
insert into e6(word,meaning) value('sheriff',                	'n.郡长;警察局长');
insert into e6(word,meaning) value('shipbuilding',           	'n.造船(业),造船学');
insert into e6(word,meaning) value('shipment',               	'n.装货;装载的货物');
insert into e6(word,meaning) value('shipwreck',              	'n.船舶失事');
insert into e6(word,meaning) value('shortage',               	'n.短缺,不足额');
insert into e6(word,meaning) value('shortcut',               	'n.近路,捷径');
insert into e6(word,meaning) value('shorten',                	'vt.弄短,缩小,减少');
insert into e6(word,meaning) value('shorthand',              	'n.速记,速记法');
insert into e6(word,meaning) value('should',                 	'v.aux.应该,竟然会');
insert into e6(word,meaning) value('shoulder',               	'vt.承担,挑起,肩负');
insert into e6(word,meaning) value('shove',                  	'vt.推 vi.(使劲)推');
insert into e6(word,meaning) value('shovel',                 	'n.铲,铁铲 vt.铲');
insert into e6(word,meaning) value('shower',                 	'vi.下阵雨 vt.使湿透');
insert into e6(word,meaning) value('shrill',                 	'a.尖声的 vt.尖声地叫');
insert into e6(word,meaning) value('shrimp',                 	'n.(小)虾,河虾,褐虾');
insert into e6(word,meaning) value('shrine',                 	'n.神殿,神龛,圣祠');
insert into e6(word,meaning) value('shrub',                  	'n.灌木,灌木丛');
insert into e6(word,meaning) value('shrug',                  	'vt.&vi.耸(肩) n.耸肩');
insert into e6(word,meaning) value('shutter',                	'n.百叶窗;(相机)快门');
insert into e6(word,meaning) value('shuttle',                	'n.(织机的)梭');
insert into e6(word,meaning) value('sideways',               	'ad.斜向一边地');
insert into e6(word,meaning) value('siege',                  	'n.包围,围攻,围困');
insert into e6(word,meaning) value('sift',                   	'vt.筛,过滤 vi.通过');
insert into e6(word,meaning) value('sight',                  	'n.情景,名胜,风景');
insert into e6(word,meaning) value('sign',                   	'n.征兆,迹象,病症');
insert into e6(word,meaning) value('significant',            	'a.有效的');
insert into e6(word,meaning) value('signify',                	'vt.表示,意味着');
insert into e6(word,meaning) value('silicon',                	'n.硅(旧名矽)');
insert into e6(word,meaning) value('similarity',             	'n.类似,相似;类似点');
insert into e6(word,meaning) value('simple',                 	'a.单纯的;迟钝的');
insert into e6(word,meaning) value('simplicity',             	'n.单纯,质朴');
insert into e6(word,meaning) value('simultaneous',           	'a.同时的,同时存在的');
insert into e6(word,meaning) value('sincerity',              	'n.真诚,诚意;真实');
insert into e6(word,meaning) value('singular',               	'a.异常的,奇异的');
insert into e6(word,meaning) value('sink',                   	'n.(厨房内的)洗涤槽');
insert into e6(word,meaning) value('siren',                  	'n.汽笛,警报器');
insert into e6(word,meaning) value('sitting-room',           	'n.起居室');
insert into e6(word,meaning) value('situated',               	'a.位于…的');
insert into e6(word,meaning) value('situation',              	'n.(建筑物等的)位置');
insert into e6(word,meaning) value('skeleton',               	'n.骨骼,骷髅;骨架');
insert into e6(word,meaning) value('skip',                   	'vi.跳;跳绳;略过');
insert into e6(word,meaning) value('skyscraper',             	'n.摩天楼');
insert into e6(word,meaning) value('slack',                  	'a.萧条的;懈怠的');
insert into e6(word,meaning) value('slander',                	'n.&vt.诽谤,诋毁');
insert into e6(word,meaning) value('slang',                  	'n.俚语;行话,黑话');
insert into e6(word,meaning) value('slap',                   	'vt.掴,拍 n.巴掌,拍');
insert into e6(word,meaning) value('slaughter',              	'vt.&n.屠杀,屠宰');
insert into e6(word,meaning) value('slave',                  	'vi.作苦工 vt.奴役');
insert into e6(word,meaning) value('slide',                  	'n.滑板,滑座');
insert into e6(word,meaning) value('slim',                   	'a.细长的;微小的');
insert into e6(word,meaning) value('slit',                   	'vt.切开 n.狭长的切口');
insert into e6(word,meaning) value('slumber',                	'n.睡眠;沉睡状态');
insert into e6(word,meaning) value('smart',                  	'vi.刺疼,扎疼,剧痛');
insert into e6(word,meaning) value('smash',                  	'vt.打碎,打破,粉碎');
insert into e6(word,meaning) value('smuggle',                	'vt.私运 vi.走私');
insert into e6(word,meaning) value('snack',                  	'n.快餐,小吃');
insert into e6(word,meaning) value('snail',                  	'n.蜗牛;行动缓慢的人');
insert into e6(word,meaning) value('snap',                   	'vt.猛咬,突然折断');
insert into e6(word,meaning) value('sneer',                  	'vi.&n.冷笑;嘲笑');
insert into e6(word,meaning) value('sneeze',                 	'vi.打喷嚏');
insert into e6(word,meaning) value('sniff',                  	'vi.用鼻子吸 vt.嗅');
insert into e6(word,meaning) value('snob',                   	'n.势利小人');
insert into e6(word,meaning) value('snobbish',               	'a.势利的,谄上欺下的');
insert into e6(word,meaning) value('snore',                  	'vi.打鼾,打呼噜');
insert into e6(word,meaning) value('sociology',              	'n.社会学');
insert into e6(word,meaning) value('sodium',                 	'n.钠');
insert into e6(word,meaning) value('sofa',                   	'n.长沙发,沙发');
insert into e6(word,meaning) value('soften',                 	'vt.使软化 vi.变软弱');
insert into e6(word,meaning) value('softness',               	'n.温和,柔和;软弱');
insert into e6(word,meaning) value('software',               	'n.(计算机的)软件');
insert into e6(word,meaning) value('solar',                  	'a.利用太阳光的');
insert into e6(word,meaning) value('solidarity',             	'n.团结;休戚相关');
insert into e6(word,meaning) value('solidify',               	'vt.&vi.团结;凝固');
insert into e6(word,meaning) value('solo',                   	'n.独唱,独奏;独唱曲');
insert into e6(word,meaning) value('sophisticated',          	'a.老于世故的;高级的');
insert into e6(word,meaning) value('sorrowful',              	'a.使人伤心的;悲伤的');
insert into e6(word,meaning) value('southwards',             	'ad.向南方');
insert into e6(word,meaning) value('sovereign',              	'n.君主 a.统治的');
insert into e6(word,meaning) value('souvenir',               	'n.纪念品,黄豆');
insert into e6(word,meaning) value('soy',                    	'n.酱油;大豆,黄豆');
insert into e6(word,meaning) value('spacious',               	'a.广阔的,广大的');
insert into e6(word,meaning) value('span',                   	'n.(桥墩间的)墩距');
insert into e6(word,meaning) value('spatial',                	'a.空间的,占据空间的');
insert into e6(word,meaning) value('specialize',             	'vt.使专门化,专业化');
insert into e6(word,meaning) value('species',                	'n.种,物种;种类');
insert into e6(word,meaning) value('specification',          	'n.载明,详述;规格');
insert into e6(word,meaning) value('specimen',               	'n.抽样,样品');
insert into e6(word,meaning) value('spectacle',              	'n.场面;景象,奇观');
insert into e6(word,meaning) value('spectator',              	'n.参观者,观众');
insert into e6(word,meaning) value('spectrum',               	'n.系列,范围;波谱');
insert into e6(word,meaning) value('speculate',              	'vi.思索,沉思;投机');
insert into e6(word,meaning) value('spherical',              	'a.球形的,球面的');
insert into e6(word,meaning) value('spice',                  	'n.香料,调味品;香气');
insert into e6(word,meaning) value('spill',                  	'n.(人)摔下,跌下');
insert into e6(word,meaning) value('spiral',                 	'a.螺旋(形)的,盘旋的');
insert into e6(word,meaning) value('spite',                  	'n.恶意,怨恨');
insert into e6(word,meaning) value('splash',                 	'vt.溅泼 vi.泼水 n.溅');
insert into e6(word,meaning) value('split',                  	'n.分裂,分化;派系');
insert into e6(word,meaning) value('spokesman',              	'n.发言人,代言人');
insert into e6(word,meaning) value('squash',                 	'vt.压碎 n.鲜果汁');
insert into e6(word,meaning) value('squat',                  	'vi.&vt.(使)蹲下');
insert into e6(word,meaning) value('squeeze',                	'n.压榨;榨取,佣金');
insert into e6(word,meaning) value('stability',              	'n.坚定');
insert into e6(word,meaning) value('stagger',                	'vi.蹒跚 vt.使摇晃');
insert into e6(word,meaning) value('stainless',              	'a.纯洁的;不锈的');
insert into e6(word,meaning) value('stairway',               	'n.楼梯');
insert into e6(word,meaning) value('stalk',                  	'n.主茎,叶柄;高烟囱');
insert into e6(word,meaning) value('stall',                  	'n.货摊,书摊;厩');
insert into e6(word,meaning) value('stammer',                	'vt.口吃地说 n.口吃');
insert into e6(word,meaning) value('standardize',            	'vt.使与标准比较');
insert into e6(word,meaning) value('start',                  	'vt.开动,着手;开设');
insert into e6(word,meaning) value('stationery',             	'n.文具;信笺');
insert into e6(word,meaning) value('statistics',             	'n.统计,统计数字');
insert into e6(word,meaning) value('steady',                 	'a.坚定的,扎实的');
insert into e6(word,meaning) value('steak',                  	'n.大块牛肉;牛排');
insert into e6(word,meaning) value('steal',                  	'vt.偷偷地做,巧取');
insert into e6(word,meaning) value('stem',                   	'n.词干;(手表的)转柄');
insert into e6(word,meaning) value('stereo',                 	'n.立体声 a.立体声的');
insert into e6(word,meaning) value('stern',                  	'n.艉,船尾;臀部');
insert into e6(word,meaning) value('stew',                   	'vt.炖 vi.炖着 n.炖肉');
insert into e6(word,meaning) value('stiff',                  	'a.生硬的');
insert into e6(word,meaning) value('stiffness',              	'n.硬度');
insert into e6(word,meaning) value('stillness',              	'n.寂静,无声');
insert into e6(word,meaning) value('sting',                  	'n.剧痛;刺激 vt.刺');
insert into e6(word,meaning) value('stitch',                 	'n.一针,缝线 vt.缝');
insert into e6(word,meaning) value('stone',                  	'n.果核,(水果的)硬核');
insert into e6(word,meaning) value('storage',                	'n.贮藏,保管;仓库');
insert into e6(word,meaning) value('storm',                  	'n.爆发 vt.&vi.猛攻');
insert into e6(word,meaning) value('stout',                  	'a.矮胖的;坚固的');
insert into e6(word,meaning) value('straighten',             	'vt.把…弄直vi.挺起来');
insert into e6(word,meaning) value('straightforward',        	'a.老实的 ad.坦率地');
insert into e6(word,meaning) value('strait',                 	'n.海峡');
insert into e6(word,meaning) value('strange',                	'a.外地的,异乡的');
insert into e6(word,meaning) value('stray',                  	'vi.迷路 a.迷路的');
insert into e6(word,meaning) value('streamline',             	'n.流线;流线型');
insert into e6(word,meaning) value('strength',               	'n.兵力;强度');
insert into e6(word,meaning) value('stride',                 	'vi.大踏步走 n.大步');
insert into e6(word,meaning) value('strife',                 	'n.冲突,竞争');
insert into e6(word,meaning) value('striking',               	'a.显著的,惊人的');
insert into e6(word,meaning) value('strip',                  	'n.窄条,长带');
insert into e6(word,meaning) value('strive',                 	'vi.努力,奋斗,力求');
insert into e6(word,meaning) value('stroll',                 	'n.散步,溜达,闲逛');
insert into e6(word,meaning) value('stubborn',               	'a.顽固的;顽强的');
insert into e6(word,meaning) value('studio',                 	'n.工作室;播音室');
insert into e6(word,meaning) value('stuffy',                 	'a.不透气的,闷热的');
insert into e6(word,meaning) value('sturdy',                 	'a.坚定的;牢固的');
insert into e6(word,meaning) value('subdivide',              	'vt.把…再分');
insert into e6(word,meaning) value('subdue',                 	'vt.使屈服,征服');
insert into e6(word,meaning) value('subject',                	'vt.使隶属');
insert into e6(word,meaning) value('subordinate',            	'a.下级的,辅助的');
insert into e6(word,meaning) value('subscribe',              	'vi.订购,认购;预订');
insert into e6(word,meaning) value('subscript',              	'a.写在下方的 n.下标');
insert into e6(word,meaning) value('subscription',           	'n.预约,用户,订阅费');
insert into e6(word,meaning) value('subsequent',             	'a.尔后的');
insert into e6(word,meaning) value('subsequently',           	'ad.其后,其次,接着');
insert into e6(word,meaning) value('subsidiary',             	'a.辅助的,补充的');
insert into e6(word,meaning) value('substance',              	'n.财产;内容,本旨');
insert into e6(word,meaning) value('substantial',            	'a.物质的;坚固的');
insert into e6(word,meaning) value('subtle',                 	'a.微妙的;精巧的');
insert into e6(word,meaning) value('succession',             	'n.继承(权),后裔');
insert into e6(word,meaning) value('successor',              	'n.继承人,继任者');
insert into e6(word,meaning) value('suffice',                	'vi.足够;有能力');
insert into e6(word,meaning) value('suicide',                	'n.&vi.&vt.自杀');
insert into e6(word,meaning) value('suit',                   	'vt.使配合vi.彼此协调');
insert into e6(word,meaning) value('suitcase',               	'n.小提箱,衣箱');
insert into e6(word,meaning) value('sullen',                 	'a.绷着脸不高兴的');
insert into e6(word,meaning) value('summary',                	'a.概括的;速决的');
insert into e6(word,meaning) value('summit',                 	'n.顶点,最高点;极度');
insert into e6(word,meaning) value('summon',                 	'vt.召唤;鼓起(勇气)');
insert into e6(word,meaning) value('superb',                 	'a.壮丽的;超等的');
insert into e6(word,meaning) value('superficial',            	'a.表面的;肤浅的');
insert into e6(word,meaning) value('superiority',            	'n.优越(性),优势');
insert into e6(word,meaning) value('supersonic',             	'a.超声的,超声速的');
insert into e6(word,meaning) value('superstition',           	'n.迷信,迷信行为');
insert into e6(word,meaning) value('supervise',              	'vt.&vi.监督,监视');
insert into e6(word,meaning) value('supplement',             	'n.补角');
insert into e6(word,meaning) value('support',                	'vt.经受,承受,忍受');
insert into e6(word,meaning) value('suppress',               	'vt.镇压;抑制;隐瞒');
insert into e6(word,meaning) value('surpass',                	'vt.超过,超越,胜过');
insert into e6(word,meaning) value('surplus',                	'n.过剩,剩余(物资)');
insert into e6(word,meaning) value('survival',               	'n.幸存,残存;幸存者');
insert into e6(word,meaning) value('suspicious',             	'a.可疑的;猜疑的');
insert into e6(word,meaning) value('sweeten',                	'vt.使变甜 vi.变甜');
insert into e6(word,meaning) value('sweetness',              	'n.甜蜜;新鲜;温和');
insert into e6(word,meaning) value('swell',                  	'vi.&vt.使膨胀,隆起');
insert into e6(word,meaning) value('switch',                 	'n.(树木的)软枝条');
insert into e6(word,meaning) value('symmetrical',            	'a.对称的,匀称的');
insert into e6(word,meaning) value('symmetry',               	'n.对称(性),匀称');
insert into e6(word,meaning) value('symphony',               	'n.交响乐;交响乐团');
insert into e6(word,meaning) value('symposium',              	'n.酒会;座谈会');
insert into e6(word,meaning) value('symptom',                	'n.症状,征候,征兆');
insert into e6(word,meaning) value('synthesis',              	'n.合成;综合,综合物');
insert into e6(word,meaning) value('systematic',             	'a.成体系的;分类的');
insert into e6(word,meaning) value('systematically',         	'ad.系统地,有规则地');
insert into e6(word,meaning) value('tabulate',               	'vt.把…制成表');
insert into e6(word,meaning) value('tack',                   	'n.平头打 vt.钉住');
insert into e6(word,meaning) value('tackle',                 	'vt.解决,对付 n.用具');
insert into e6(word,meaning) value('tact',                   	'n.机敏,圆滑,得体');
insert into e6(word,meaning) value('tactics',                	'n.策略;战术,兵法');
insert into e6(word,meaning) value('tangle',                 	'vt.使缠结,使纠缠');
insert into e6(word,meaning) value('tanker',                 	'n.油船;空中加油飞机');
insert into e6(word,meaning) value('tape',                   	'vt.系,捆');
insert into e6(word,meaning) value('taper',                  	'n.细小的蜡烛;微光');
insert into e6(word,meaning) value('tar',                    	'n.柏油,焦油');
insert into e6(word,meaning) value('team',                   	'vi.协作,合作');
insert into e6(word,meaning) value('tease',                  	'vt.逗乐,戏弄;强求');
insert into e6(word,meaning) value('telex',                  	'n.电传,用户电报');
insert into e6(word,meaning) value('tempt',                  	'vt.引诱,诱惑,劝诱');
insert into e6(word,meaning) value('tensile',                	'a.张力的;能伸长的');
insert into e6(word,meaning) value('terminal',               	'n.计算机终端;线接头');
insert into e6(word,meaning) value('terminate',              	'vt.&vi.停止,终止');
insert into e6(word,meaning) value('terminology',            	'n.术语学,术语');
insert into e6(word,meaning) value('terrace',                	'n.平台,阳台,露台');
insert into e6(word,meaning) value('terrify',                	'vt.使恐怖,使惊吓');
insert into e6(word,meaning) value('terrorist',              	'n.恐怖分子');
insert into e6(word,meaning) value('testify',                	'v.证明,证实,作证');
insert into e6(word,meaning) value('Thanksgiving',           	'n.感恩节');
insert into e6(word,meaning) value('theatre',                	'n.戏剧效果');
insert into e6(word,meaning) value('theft',                  	'n.盗窃,偷窃(行为)');
insert into e6(word,meaning) value('theme',                  	'n.题目;词干;主旋律');
insert into e6(word,meaning) value('theorem',                	'n.定理;原理,原则');
insert into e6(word,meaning) value('theory',                 	'n.见解,看法,推测');
insert into e6(word,meaning) value('thereafter',             	'ad.此后,以后');
insert into e6(word,meaning) value('therein',                	'ad.在那里,在那时');
insert into e6(word,meaning) value('thereof',                	'ad.它的,其;由此');
insert into e6(word,meaning) value('thermal',                	'a.热的;温泉的');
insert into e6(word,meaning) value('thesis',                 	'n.论题,论点;论文');
insert into e6(word,meaning) value('thicken',                	'vt.使变厚(或粗、密)');
insert into e6(word,meaning) value('thigh',                  	'n.股,大腿');
insert into e6(word,meaning) value('thorough',               	'a.精心的;详尽的');
insert into e6(word,meaning) value('thoughtless',            	'a.欠考虑的;自私的');
insert into e6(word,meaning) value('thrash',                 	'vt.痛打,鞭打 vi.打');
insert into e6(word,meaning) value('thresh',                 	'vt.打谷,脱粒;推敲');
insert into e6(word,meaning) value('threshold',              	'n.门槛;入门,开端');
insert into e6(word,meaning) value('thrifty',                	'a.节俭的;兴旺的');
insert into e6(word,meaning) value('thrill',                 	'vt.&vi.(使)激动');
insert into e6(word,meaning) value('through',                	'prep.因为,由于');
insert into e6(word,meaning) value('ticket',                 	'n.(交通违章)罚款传票');
insert into e6(word,meaning) value('tickle',                 	'vt.挠,胳肢;逗乐');
insert into e6(word,meaning) value('tighten',                	'vt.&vi.(使)变紧');
insert into e6(word,meaning) value('tightly',                	'ad.紧地,牢固地');
insert into e6(word,meaning) value('tile',                   	'n.瓦片,瓷砖;贴砖');
insert into e6(word,meaning) value('tilt',                   	'vt.&vi.(使)倾斜');
insert into e6(word,meaning) value('timely',                 	'a.及时的;适时的');
insert into e6(word,meaning) value('tiresome',               	'a.使人厌倦的,讨厌的');
insert into e6(word,meaning) value('toad',                   	'n.蟾蜍,癞蛤蟆');
insert into e6(word,meaning) value('token',                  	'n.象征;辅币;纪念品');
insert into e6(word,meaning) value('tolerant',               	'a.容忍的;有耐力的');
insert into e6(word,meaning) value('tone',                   	'n.色调,光度;风气');
insert into e6(word,meaning) value('torment',                	'n.痛苦 vt.折磨');
insert into e6(word,meaning) value('torpedo',                	'n.鱼雷,水雷');
insert into e6(word,meaning) value('torque',                 	'n.转(力)矩,扭(力)矩');
insert into e6(word,meaning) value('toss',                   	'vi.翻来复去');
insert into e6(word,meaning) value('tow',                    	'vt.&n.拖引,牵引');
insert into e6(word,meaning) value('towards',                	'prep.为了,有助于');
insert into e6(word,meaning) value('tower',                  	'vi.高耸,屹立;翱翔');
insert into e6(word,meaning) value('track',                  	'vi.留下足迹');
insert into e6(word,meaning) value('trade',                  	'vi.做买卖;交换');
insert into e6(word,meaning) value('trader',                 	'n.商人;商船');
insert into e6(word,meaning) value('tradesman',              	'n.商人;手艺人');
insert into e6(word,meaning) value('tragic',                 	'a.悲剧性的,悲惨的');
insert into e6(word,meaning) value('tramp',                  	'vt.&vi.&n.步行,跋涉');
insert into e6(word,meaning) value('trample',                	'vt.&vi.&n.践踏,蹂躏');
insert into e6(word,meaning) value('tranquil',               	'a.平静的;稳定的');
insert into e6(word,meaning) value('transaction',            	'n.处理;交易;和解');
insert into e6(word,meaning) value('transform',              	'vt.变压;变换');
insert into e6(word,meaning) value('transition',             	'n.转变,变迁;过渡');
insert into e6(word,meaning) value('transmission',           	'n.遗传,传染');
insert into e6(word,meaning) value('transplant',             	'vt.&vi.移植,移种');
insert into e6(word,meaning) value('transverse',             	'a.横切的 n.横轴');
insert into e6(word,meaning) value('traverse',               	'vt.横越,横切,横断');
insert into e6(word,meaning) value('tread',                  	'vi.&vt.踩,踏,践踏');
insert into e6(word,meaning) value('treasurer',              	'n.司库,财务主管');
insert into e6(word,meaning) value('trench',                 	'n.深沟;壕沟,战壕');
insert into e6(word,meaning) value('triangular',             	'a.三角的;三者间的');
insert into e6(word,meaning) value('tribute',                	'n.贡物;献礼,贡献');
insert into e6(word,meaning) value('trifle',                 	'vi.玩忽;闲混;嬉耍');
insert into e6(word,meaning) value('trigger',                	'n.扳机 vt.触发,引起');
insert into e6(word,meaning) value('triumphant',             	'a.得胜的;得意洋洋的');
insert into e6(word,meaning) value('trivial',                	'a.琐碎的;平常的');
insert into e6(word,meaning) value('trolley',                	'n.手推车;无轨电车');
insert into e6(word,meaning) value('troop',                  	'n.一群,一队,大量');
insert into e6(word,meaning) value('tropic',                 	'n.热带地区;回归线');
insert into e6(word,meaning) value('tropical',               	'a.热带的;炎热的');
insert into e6(word,meaning) value('trot',                   	'vi.&n.(马)小跑,慢跑');
insert into e6(word,meaning) value('troublesome',            	'a.累赘的,困难的');
insert into e6(word,meaning) value('tuberculosis',           	'n.结核病,肺结核');
insert into e6(word,meaning) value('tug',                    	'vi.用力拖 n.猛拉,拖');
insert into e6(word,meaning) value('tulip',                  	'n.郁金香');
insert into e6(word,meaning) value('tuna',                   	'n.金枪鱼');
insert into e6(word,meaning) value('turtle',                 	'n.海龟,玳瑁;甲鱼肉');
insert into e6(word,meaning) value('tutor',                  	'vt.教,指导');
insert into e6(word,meaning) value('twilight',               	'n.黎明,黄昏;曙光');
insert into e6(word,meaning) value('twist',                  	'v.歪曲,曲解');
insert into e6(word,meaning) value('tyranny',                	'n.暴政,专制;残暴');
insert into e6(word,meaning) value('tyrant',                 	'n.暴君;专制君主');
insert into e6(word,meaning) value('ultimate',               	'a.基本的,首要的');
insert into e6(word,meaning) value('ultrasonic',             	'a.超声的 n.超声波');
insert into e6(word,meaning) value('ultraviolet',            	'a.紫外的n.紫外线辐射');
insert into e6(word,meaning) value('unanimous',              	'a.(全体)一致的');
insert into e6(word,meaning) value('uncertain',              	'a.不定的;无常的');
insert into e6(word,meaning) value('underestimate',          	'vt.低估,看轻');
insert into e6(word,meaning) value('underline',              	'vt.着重;预告');
insert into e6(word,meaning) value('undertake',              	'vt.约定,保证;从事');
insert into e6(word,meaning) value('undertaking',            	'n.任务,事业;承担');
insert into e6(word,meaning) value('underwear',              	'n.衫衣,内衣,贴身衣');
insert into e6(word,meaning) value('undesirable',            	'a.不合需要的;讨厌的');
insert into e6(word,meaning) value('uneasy',                 	'a.不安的;拘束的');
insert into e6(word,meaning) value('unemployment',           	'n.失业;失业人数');
insert into e6(word,meaning) value('unfit',                  	'a.不合适的;无能力的');
insert into e6(word,meaning) value('unfold',                 	'vt.展开 vi.呈现');
insert into e6(word,meaning) value('uniformly',              	'ad.相同地;一贯');
insert into e6(word,meaning) value('unique',                 	'a.无可匹敌的;极好的');
insert into e6(word,meaning) value('universally',            	'ad.普遍地,一般地');
insert into e6(word,meaning) value('unlimited',              	'a.无限的;不定的');
insert into e6(word,meaning) value('unlock',                 	'vt.开…的锁;开启');
insert into e6(word,meaning) value('unpaid',                 	'a.未付的;不支薪水的');
insert into e6(word,meaning) value('unreasonable',           	'a.不讲道理的;过度的');
insert into e6(word,meaning) value('untie',                  	'vt.解开,松开;解放');
insert into e6(word,meaning) value('uphold',                 	'vt.举起;支撑;赞成');
insert into e6(word,meaning) value('uproar',                 	'n.骚动,扰乱;喧嚣');
insert into e6(word,meaning) value('uranium',                	'n.铀');
insert into e6(word,meaning) value('urge',                   	'vt.&vi.强烈希望');
insert into e6(word,meaning) value('usage',                  	'n.习惯法');
insert into e6(word,meaning) value('utensil',                	'n.器皿,用具');
insert into e6(word,meaning) value('utilization',            	'n.利用,效用');
insert into e6(word,meaning) value('vaccinate',              	'vt.给…种牛痘');
insert into e6(word,meaning) value('validity',               	'n.有效,效力;正确');
insert into e6(word,meaning) value('valuable',               	'n.贵重物品,财宝');
insert into e6(word,meaning) value('value',                  	'vt.尊重,重视,评价');
insert into e6(word,meaning) value('valve',                  	'n.阀,阀门;电子管');
insert into e6(word,meaning) value('vault',                  	'n.拱顶;地下室,地窖');
insert into e6(word,meaning) value('vector',                 	'n.矢量;飞机航线');
insert into e6(word,meaning) value('veil',                   	'vt.以面纱遮掩vi.遮盖');
insert into e6(word,meaning) value('vein',                   	'n.静脉,血管,矿脉');
insert into e6(word,meaning) value('velocity',               	'n.迅速,快速');
insert into e6(word,meaning) value('velvet',                 	'a.丝绒制的;柔软的');
insert into e6(word,meaning) value('vengeance',              	'n.报复,报仇,复仇');
insert into e6(word,meaning) value('ventilate',              	'vt.使通风,使换气');
insert into e6(word,meaning) value('Venus',                  	'n.维纳斯;美人;色情');
insert into e6(word,meaning) value('verge',                  	'n.边缘,边界,界限');
insert into e6(word,meaning) value('versatile',              	'a.多方面的;通用的');
insert into e6(word,meaning) value('verse',                  	'n.诗,韵文;诗行');
insert into e6(word,meaning) value('version',                	'n.解释');
insert into e6(word,meaning) value('versus',                 	'prep.(比赛等中)对');
insert into e6(word,meaning) value('veto',                   	'n.否决,否决权,禁止');
insert into e6(word,meaning) value('vicinity',               	'n.邻近;附近地区');
insert into e6(word,meaning) value('vicious',                	'a.邪恶的;恶性的');
insert into e6(word,meaning) value('video',                  	'a.录象的');
insert into e6(word,meaning) value('vigorous',               	'a.精力旺盛的,茁壮的');
insert into e6(word,meaning) value('vigour',                 	'n.活力,精力;元气');
insert into e6(word,meaning) value('villa',                  	'n.别墅;城郊小屋');
insert into e6(word,meaning) value('vine',                   	'n.蔓,藤,藤本植物');
insert into e6(word,meaning) value('violate',                	'vt.违犯,违背;侵犯');
insert into e6(word,meaning) value('violation',              	'n.违犯;侵犯,妨碍');
insert into e6(word,meaning) value('violent',                	'a.狂暴的;歪曲的');
insert into e6(word,meaning) value('virgin',                 	'n.处女 a.处女的');
insert into e6(word,meaning) value('virtual',                	'a.实际上的,实质上的');
insert into e6(word,meaning) value('visa',                   	'n.签证');
insert into e6(word,meaning) value('viscous',                	'a.粘滞的,粘性的');
insert into e6(word,meaning) value('vision',                 	'n.视力;眼光,想象力');
insert into e6(word,meaning) value('visit',                  	'vt.常去');
insert into e6(word,meaning) value('vital',                  	'a.生命的,生机的');
insert into e6(word,meaning) value('vitamin',                	'n.维生素,维他命');
insert into e6(word,meaning) value('vocabulary',             	'n.词汇表,词汇汇编');
insert into e6(word,meaning) value('vocation',               	'n.职业,行业');
insert into e6(word,meaning) value('void',                   	'a.空的;无效的');
insert into e6(word,meaning) value('volunteer',              	'n.志愿者 vt.志愿');
insert into e6(word,meaning) value('vow',                    	'n.誓言,誓约,许愿');
insert into e6(word,meaning) value('vowel',                  	'n.元音;元音字母');
insert into e6(word,meaning) value('vulgar',                 	'a.粗俗的,庸俗的');
insert into e6(word,meaning) value('wade',                   	'vt.趟(河),跋涉');
insert into e6(word,meaning) value('wag',                    	'vt.摇,摇摆,摆动');
insert into e6(word,meaning) value('waggon',                 	'n.敞蓬车厢');
insert into e6(word,meaning) value('waitress',               	'n.女侍者,女服务员');
insert into e6(word,meaning) value('walnut',                 	'n.胡桃,核桃树');
insert into e6(word,meaning) value('ward',                   	'n.病房,病室;监房');
insert into e6(word,meaning) value('wardrobe',               	'n.衣柜,衣橱,藏衣室');
insert into e6(word,meaning) value('ware',                   	'n.商品,货物;物品');
insert into e6(word,meaning) value('warehouse',              	'n.仓库,货栈');
insert into e6(word,meaning) value('warfare',                	'n.战争,战争状态');
insert into e6(word,meaning) value('warning',                	'n.警告,告诫,鉴诫');
insert into e6(word,meaning) value('warrant',                	'n.许可证,委任状');
insert into e6(word,meaning) value('wasp',                   	'n.黄蜂,蚂蜂');
insert into e6(word,meaning) value('wasteful',               	'a.浪费的;破坏性的');
insert into e6(word,meaning) value('watchful',               	'a.注意的,警惕的');
insert into e6(word,meaning) value('watertight',             	'a.不漏水的,防水的');
insert into e6(word,meaning) value('watery',                 	'a.水的;湿的;乏味的');
insert into e6(word,meaning) value('watt',                   	'n.瓦(特)');
insert into e6(word,meaning) value('waver',                  	'vi.摇摆;犹豫不决');
insert into e6(word,meaning) value('way',                    	'n.状态,状况,规模');
insert into e6(word,meaning) value('weaver',                 	'n.织布工,编织者');
insert into e6(word,meaning) value('web',                    	'n.网,丝,网状物');
insert into e6(word,meaning) value('wedge',                  	'n.楔 vt.楔入;挤入');
insert into e6(word,meaning) value('whale',                  	'n.鲸;庞然大物');
insert into e6(word,meaning) value('wharf',                  	'n.码头,停泊所');
insert into e6(word,meaning) value('what',                   	'a.所…的,尽可能多的');
insert into e6(word,meaning) value('whereby',                	'ad.靠什么;靠那个');
insert into e6(word,meaning) value('whilst',                 	'conj.同…同时;然而');
insert into e6(word,meaning) value('whisker',                	'n.髯,连鬓胡子');
insert into e6(word,meaning) value('whisper',                	'vt.低声地讲,私下说');
insert into e6(word,meaning) value('white',                  	'a.白种(人)的');
insert into e6(word,meaning) value('whitewash',              	'n.石灰水 vt.粉饰');
insert into e6(word,meaning) value('whoever',                	'pron.究竟是谁');
insert into e6(word,meaning) value('wholesome',              	'a.适合卫生的');
insert into e6(word,meaning) value('widely',                 	'ad.大大地');
insert into e6(word,meaning) value('wield',                  	'vt.挥(剑);行使');
insert into e6(word,meaning) value('willow',                 	'n.柳树,柳木');
insert into e6(word,meaning) value('wind',                   	'n.胸口,心窝');
insert into e6(word,meaning) value('winding',                	'n.卷绕着的线a.卷曲的');
insert into e6(word,meaning) value('windmill',               	'n.风车');
insert into e6(word,meaning) value('windy',                  	'a.多风的,刮风的');
insert into e6(word,meaning) value('wink',                   	'vi.眨眼;使眼色');
insert into e6(word,meaning) value('wisdom',                 	'n.(古人的)名言,格言');
insert into e6(word,meaning) value('wither',                 	'vi.枯萎 vt.使衰弱');
insert into e6(word,meaning) value('whereas',                	'conj.而,却,反之');
insert into e6(word,meaning) value('witty',                  	'a.机智的;风趣的');
insert into e6(word,meaning) value('woe',                    	'n.悲哀,悲痛,苦恼');
insert into e6(word,meaning) value('woodpecker',             	'n.啄木鸟');
insert into e6(word,meaning) value('workpiece',              	'n.工(作)件');
insert into e6(word,meaning) value('workshop',               	'n.专题讨论会');
insert into e6(word,meaning) value('worship',                	'vt.崇拜 vi.做礼拜');
insert into e6(word,meaning) value('wrath',                  	'n.暴怒,狂怒,愤慨');
insert into e6(word,meaning) value('wrench',                 	'vt.拧,扭伤 n.拧');
insert into e6(word,meaning) value('wrestle',                	'n.摔交;斗争,搏斗');
insert into e6(word,meaning) value('wretched',               	'a.不幸的;卑鄙的');
insert into e6(word,meaning) value('wring',                  	'vt.拧,挤,扭,榨');
insert into e6(word,meaning) value('wrinkle',                	'n.皱纹 vt.使起皱纹');
insert into e6(word,meaning) value('xerox',                  	'vt.&vi.用静电复印');
insert into e6(word,meaning) value('yacht',                  	'n.游艇,快艇');
insert into e6(word,meaning) value('yearn',                  	'vi.想念,怀念,向往');
insert into e6(word,meaning) value('yeast',                  	'n.酵母');
insert into e6(word,meaning) value('yoke',                   	'n.轭,牛轭;枷锁');
insert into e6(word,meaning) value('yolk',                   	'n.蛋黄,卵黄');
insert into e6(word,meaning) value('youngster',              	'n.儿童,少年,年轻人');
insert into e6(word,meaning) value('zinc',                   	'n.锌 vt.在…上镀锌');